TCGCTTGAAGAAATCATAT->CGCTTGAAGAAATCATATT
GGAAAGACTCAGATTGATA->GAAAGACTCAGATTGATAT
ATCTGCTCATGTCGCCAGC->TCTGCTCATGTCGCCAGCG
TTCTTCAACTCTTGACCTC->TCTTCAACTCTTGACCTCC
AGCCCTATCACCCCGGAAA->GCCCTATCACCCCGGAAAG
TTACGGAAGGATCTGTCAC->TACGGAAGGATCTGTCACA
TTTAGGCCAAGATTCCTTA->TTAGGCCAAGATTCCTTAT
GCTAATTTCAGACTACTCT->CTAATTTCAGACTACTCTA
GTACACCACCCAGCAAGTT->TACACCACCCAGCAAGTTC
AGGGGCCAGCCTTATGCAA->GGGGCCAGCCTTATGCAAG
TGTTAGTACGTAGACTTCG->GTTAGTACGTAGACTTCGT
TCGGGTAGGAGCCCTCAGA->CGGGTAGGAGCCCTCAGAG
TGCACTCGGTAGTCCCCTC->GCACTCGGTAGTCCCCTCG
AGTAATGAAAGCCGAGTGT->GTAATGAAAGCCGAGTGTG
TAACTAACCGTTATCTTTC->AACTAACCGTTATCTTTCA
TACTGCACCTAACCTTGAC->ACTGCACCTAACCTTGACC
GCCCAGGGTCCTCTCTCGA->CCCAGGGTCCTCTCTCGAT
TCTCGGCTTTGAGCCCTAG->CTCGGCTTTGAGCCCTAGG
CTGTATTCACCCTCATCGG->TGTATTCACCCTCATCGGG
CACCGCGGTGCGGCAGTCG->ACCGCGGTGCGGCAGTCGT
CATGCGCTAGCTCAAGAAA->ATGCGCTAGCTCAAGAAAG
TCCATATGCTCAAGAAAGG->CCATATGCTCAAGAAAGGG
GACTTCGTATTTGCCGGGT->ACTTCGTATTTGCCGGGTA
GGAATAGCGTAACGCGTGT->GAATAGCGTAACGCGTGTT
CACAGAGTCGTCCGGGGGC->ACAGAGTCGTCCGGGGGCA
AAATAATTAACACTGGTAT->AATAATTAACACTGGTATA
TTGATCTCGAGGGTAGAAT->TGATCTCGAGGGTAGAATT
GAAGCTTTGATCTCGAGGG->AAGCTTTGATCTCGAGGGT
GTCGTCCGGGGGCAAGTCA->TCGTCCGGGGGCAAGTCAT
TATTCTGCGGGGAGTTCTG->ATTCTGCGGGGAGTTCTGG
AAATCCGGAAAAACAAGTT->AATCCGGAAAAACAAGTTG
TAAGTTAACTCTATAATCT->AAGTTAACTCTATAATCTC
CAATAACCTAACCTTGACC->AATAACCTAACCTTGACCG
CTTATGCAAGACCTAACCT->TTATGCAAGACCTAACCTT
CTAATTTCAGACTACTCTA->TAATTTCAGACTACTCTAA
GAGTATCGGTCATCGATAA->AGTATCGGTCATCGATAAA
CCCTAACTAACCGTTATCT->CCTAACTAACCGTTATCTT
GGGGCCAGCCTTATGCAAG->GGGCCAGCCTTATGCAAGA
AAAAGGAGTGTAAAAATGT->AAAGGAGTGTAAAAATGTG
AGAATGTCGGCTCGAATTA->GAATGTCGGCTCGAATTAT
CGAGCCTGCAGGAAGCCAG->GAGCCTGCAGGAAGCCAGG
AGTCGTCCGGGGGCAAGTC->GTCGTCCGGGGGCAAGTCA
AGATGGTCGGTAGGCGGGC->GATGGTCGGTAGGCGGGCC
TGAGGATACGCAACTCCCG->GAGGATACGCAACTCCCGT
CAACCACATATGTTGCACT->AACCACATATGTTGCACTC
CAACGGCCTTGCTTCTATG->AACGGCCTTGCTTCTATGA
TGGTGTCCCGGCAACCTAG->GGTGTCCCGGCAACCTAGT
CTGCTTGGTGGTCGTCAGC->TGCTTGGTGGTCGTCAGCG
GACGCTAGTCCCCCAGTCA->ACGCTAGTCCCCCAGTCAG
AGGTCATCCCACATCAATA->GGTCATCCCACATCAATAG
TGTCACATCTCTGTGCTGG->GTCACATCTCTGTGCTGGT
GCCAGGCAGTAAGCGGACC->CCAGGCAGTAAGCGGACCT
CCCGGCAACCTAGTGAAGC->CCGGCAACCTAGTGAAGCT
GGGAAAGTTCCTAGATTCA->GGAAAGTTCCTAGATTCAT
ATTCATGCGCTAGCTCAAG->TTCATGCGCTAGCTCAAGA
TTCCTAGTCACTGCTTGGT->TCCTAGTCACTGCTTGGTG
AAAGGCTTCTCGATAATCT->AAGGCTTCTCGATAATCTA
TGCCGCATGAAGCGCAGTT->GCCGCATGAAGCGCAGTTA
TCGTCCATCCGTGTGGTCG->CGTCCATCCGTGTGGTCGA
GCTTCAGTATCTGCCGGAA->CTTCAGTATCTGCCGGAAT
TCCCGTTTGGCATGGTGTA->CCCGTTTGGCATGGTGTAT
TTTCCGCATTATGCTCACC->TTCCGCATTATGCTCACCT
TGGCCTATACGGGACTCCC->GGCCTATACGGGACTCCCA
CCGGAATTTCCATGTTCAT->CGGAATTTCCATGTTCATT
CTTTGATCTCGAGGGTAGA->TTTGATCTCGAGGGTAGAA
CAGCTGACGCGGATCCACC->AGCTGACGCGGATCCACCG
AAGGTCGGTGGCTATTAAG->AGGTCGGTGGCTATTAAGT
GCCTTGGACTAGCGCTAAA->CCTTGGACTAGCGCTAAAA
CTATCACCCCGGAAAGACT->TATCACCCCGGAAAGACTC
CGCCAGCGACAGTTTACTT->GCCAGCGACAGTTTACTTG
TGACGCGGATCCACCGCGG->GACGCGGATCCACCGCGGT
CCTCTTCACGCGACTGACA->CTCTTCACGCGACTGACAT
ATAGACGCTAGTCCCCCAG->TAGACGCTAGTCCCCCAGT
TACCAAGCTAGCCCTATCA->ACCAAGCTAGCCCTATCAC
GTCCTCTCTCGATTCCCGC->TCCTCTCTCGATTCCCGCA
GTCGGTGGCTATTAAGTCT->TCGGTGGCTATTAAGTCTG
CGTTATCTTTCAACCTCGC->GTTATCTTTCAACCTCGCC
CCAATACCGCCACCCTCGC->CAATACCGCCACCCTCGCT
AACCACATATGTTGCACTC->ACCACATATGTTGCACTCG
TTCATGCGCTAGCTCAAGA->TCATGCGCTAGCTCAAGAA
CGTAACGCGTGTTTCGCTT->GTAACGCGTGTTTCGCTTA
TCCCGACCGTCTGGTACCA->CCCGACCGTCTGGTACCAA
ATTCTCGGCTTTGAGCCCT->TTCTCGGCTTTGAGCCCTA
GGTCATCGATAAATGCTGT->GTCATCGATAAATGCTGTC
TGAAGTGGTAAAAGGATGG->GAAGTGGTAAAAGGATGGG
TTAAGTTAACTCTATAATC->TAAGTTAACTCTATAATCT
CCCTTCCCTATTTTCCACC->CCTTCCCTATTTTCCACCC
CTCTCTCGATTCCCGCATC->TCTCTCGATTCCCGCATCT
CTCTGCCGTTTTATTGAAG->TCTGCCGTTTTATTGAAGT
CGCCTGAAGGTAAGTCCGA->GCCTGAAGGTAAGTCCGAG
CTTCGTATTTGCCGGGTAG->TTCGTATTTGCCGGGTAGT
TAACTCTATAATCTCCGCT->AACTCTATAATCTCCGCTC
GCCAGTTGCTAGCCATCAT->CCAGTTGCTAGCCATCATC
GGACAGACCCCAGGCTATA->GACAGACCCCAGGCTATAA
CTTTGTGCAGCTTATATGT->TTTGTGCAGCTTATATGTG
GGCATGGTGTATATATTAT->GCATGGTGTATATATTATT
TGTGCAGCTTATATGTGTC->GTGCAGCTTATATGTGTCT
GAGTGACGGTGTGGAATGA->AGTGACGGTGTGGAATGAC
TCCACTTAAGTTAACTCTA->CCACTTAAGTTAACTCTAT
GTGTAAAAATGTGCCTTGG->TGTAAAAATGTGCCTTGGA
GACTACTCTAAGTAATGAA->ACTACTCTAAGTAATGAAA
ATAATGGGCCAATAGGTTG->TAATGGGCCAATAGGTTGA
AGCGACAGTTTACTTGTGC->GCGACAGTTTACTTGTGCT
AACCTAGTGAAGCTCATCG->ACCTAGTGAAGCTCATCGG
TTTTATTGAAGTGGTAAAA->TTTATTGAAGTGGTAAAAG
TTGAACTCAGTTCTTCAAC->TGAACTCAGTTCTTCAACT
GCCTAACCAAGTTGTGGCG->CCTAACCAAGTTGTGGCGA
AACGGCCTTGCTTCTATGA->ACGGCCTTGCTTCTATGAT
GCTTCTATGATGCCGTTAT->CTTCTATGATGCCGTTATA
ATCGTACATTGCACACTAA->TCGTACATTGCACACTAAG
TCAAGAAAGGGGCCAGACG->CAAGAAAGGGGCCAGACGC
ATTCCTTATCGAAGCTTTG->TTCCTTATCGAAGCTTTGA
CCGGCAACCTAGTGAAGCT->CGGCAACCTAGTGAAGCTC
TCGCTATACGCTCAAGAAA->CGCTATACGCTCAAGAAAG
GTTAGTACGTAGACTTCGT->TTAGTACGTAGACTTCGTA
ACATTAAGGGACAACTACA->CATTAAGGGACAACTACAT
CTGCCGCATGAAGCGCAGT->TGCCGCATGAAGCGCAGTT
ATCTCTGTGCTGGTTTCTG->TCTCTGTGCTGGTTTCTGG
TTGGTGGTCGTCAGCGGTT->TGGTGGTCGTCAGCGGTTC
AGGATACGCAACTCCCGTA->GGATACGCAACTCCCGTAG
ACCGCCTCTGACCACTAGC->CCGCCTCTGACCACTAGCG
CCGAGGAAGAGGTCATCCC->CGAGGAAGAGGTCATCCCA
CGGTGTGGAATGACAACCT->GGTGTGGAATGACAACCTC
GTATCTGCCGGAATTTCCA->TATCTGCCGGAATTTCCAT
TGACCGCCTCGCTTGAAGA->GACCGCCTCGCTTGAAGAA
CTTGTGCTTTACATCCTTC->TTGTGCTTTACATCCTTCC
TGGTATAGTTATTGAGGAA->GGTATAGTTATTGAGGAAT
ACATATCTGTCGTTAGGCT->CATATCTGTCGTTAGGCTT
ACATAAGTCCTGCCGCATG->CATAAGTCCTGCCGCATGA
TAAATGCTGTCATATCAGC->AAATGCTGTCATATCAGCT
GAACAACCAATACCGCCAC->AACAACCAATACCGCCACC
GACCGCCTCGCTTGAAGAA->ACCGCCTCGCTTGAAGAAA
CGATAAATGCTGTCATATC->GATAAATGCTGTCATATCA
CATGGTGTATATATTATTA->ATGGTGTATATATTATTAC
GCGCAGTTACGCCACTCTC->CGCAGTTACGCCACTCTCC
ATTGATATTCCCGTTACGG->TTGATATTCCCGTTACGGA
AGCCCTAGGGCAAAGAGCG->GCCCTAGGGCAAAGAGCGG
CAACTACATTGTATTGGCC->AACTACATTGTATTGGCCC
TAGCTCAAGAAAGGGGCCA->AGCTCAAGAAAGGGGCCAG
AGTATACTGCACCTAACCT->GTATACTGCACCTAACCTT
TCGGCTCGAATTATGTTAG->CGGCTCGAATTATGTTAGT
GAATGTCGGCTCGAATTAT->AATGTCGGCTCGAATTATG
ACATCAATAGTACATGGAT->CATCAATAGTACATGGATT
ACCTCCGCCAACCACATAT->CCTCCGCCAACCACATATG
GACCGTCTGGTACCAACAA->ACCGTCTGGTACCAACAAC
TTAACGGTCCGAGTCATAT->TAACGGTCCGAGTCATATT
ACTAGCGCACAAGAAATCC->CTAGCGCACAAGAAATCCC
CTTTAGGCCAAGATTCCTT->TTTAGGCCAAGATTCCTTA
CGGGTAGGAGCCCTCAGAG->GGGTAGGAGCCCTCAGAGG
GCCTTATGCAAGACCTAAC->CCTTATGCAAGACCTAACC
ATCTGGACAGACCCCAGGC->TCTGGACAGACCCCAGGCT
CCGTTTTATTGAAGTGGTA->CGTTTTATTGAAGTGGTAA
GTCCCTAACTAACCGTTAT->TCCCTAACTAACCGTTATC
TTAGGCCAAGATTCCTTAT->TAGGCCAAGATTCCTTATC
AGTTCTGGTGTCCCGGCAA->GTTCTGGTGTCCCGGCAAC
ATTCATACCGAAACATGGT->TTCATACCGAAACATGGTT
GTGTGGTCGAATAGACGCT->TGTGGTCGAATAGACGCTA
TTGAGTGACGGTGTGGAAT->TGAGTGACGGTGTGGAATG
CTTTGAGCCCTAGGGCAAA->TTTGAGCCCTAGGGCAAAG
GTCCCCCAGTCAGTGTTCA->TCCCCCAGTCAGTGTTCAT
ATCAGTCGCAATCAGAATG->TCAGTCGCAATCAGAATGT
CCTTGGACTAGCGCTAAAA->CTTGGACTAGCGCTAAAAG
GACTAGCGCTAAAAGGCTC->ACTAGCGCTAAAAGGCTCA
AATGAAAGCCGAGTGTGGT->ATGAAAGCCGAGTGTGGTG
GATTAGAGTCGCGAAAGGT->ATTAGAGTCGCGAAAGGTC
GTCCGGGGGCAAGTCATCG->TCCGGGGGCAAGTCATCGT
CTTCTATGATGCCGTTATA->TTCTATGATGCCGTTATAG
ATGACAACCTCTGACCGAT->TGACAACCTCTGACCGATT
GGCAACCTAGTGAAGCTCA->GCAACCTAGTGAAGCTCAT
CAAGTTGTACATATACAAC->AAGTTGTACATATACAACG
ATATTCACGCAAACCCAAA->TATTCACGCAAACCCAAAT
TCTGTCACATCTCTGTGCT->CTGTCACATCTCTGTGCTG
TCATCGTACATTGCACACT->CATCGTACATTGCACACTA
TGGTCGTCAGCGGTTCCCG->GGTCGTCAGCGGTTCCCGA
TGTCATGGAATAGCGTAAC->GTCATGGAATAGCGTAACG
CTGACCGATTCTCGGCTTT->TGACCGATTCTCGGCTTTG
GTTGTACATATACAACGCC->TTGTACATATACAACGCCA
GAGGGTAGAATTGTCTGGG->AGGGTAGAATTGTCTGGGT
ATCATATTCACGCAAACCC->TCATATTCACGCAAACCCA
AACTCAGTTCTTCAACTCT->ACTCAGTTCTTCAACTCTT
CAGACTACTCTAAGTAATG->AGACTACTCTAAGTAATGA
CCGCCTCCTGCGAGCCTGC->CGCCTCCTGCGAGCCTGCA
CTTGTTAATTGATTCCGGT->TTGTTAATTGATTCCGGTT
TTAGTACGTAGACTTCGTA->TAGTACGTAGACTTCGTAT
AACAACGGCCTTGCTTCTA->ACAACGGCCTTGCTTCTAT
CAGATCAGTCGCAATCAGA->AGATCAGTCGCAATCAGAA
TTGATATTCCCGTTACGGA->TGATATTCCCGTTACGGAA
GCGAAAGGTCGGTGGCTAT->CGAAAGGTCGGTGGCTATT
GACCGCCTCTGACCACTAG->ACCGCCTCTGACCACTAGC
GGCCAGTTGCTAGCCATCA->GCCAGTTGCTAGCCATCAT
TTACCTCAACTTTAGGCCA->TACCTCAACTTTAGGCCAA
GTGCCTTGGACTAGCGCTA->TGCCTTGGACTAGCGCTAA
GCTCATCGGAGGCCAGTTG->CTCATCGGAGGCCAGTTGC
GGACTAGCGCTAAAAGGCT->GACTAGCGCTAAAAGGCTC
ATGCGCTAGCTCAAGAAAG->TGCGCTAGCTCAAGAAAGG
AAGTGGTAAAAGGATGGGT->AGTGGTAAAAGGATGGGTC
TGGAATGACAACCTCTGAC->GGAATGACAACCTCTGACC
GGAGTTCTGGTGTCCCGGC->GAGTTCTGGTGTCCCGGCA
TTCATACCGAAACATGGTT->TCATACCGAAACATGGTTC
TTGTTAATTGATTCCGGTT->TGTTAATTGATTCCGGTTC
ATGTCGCCAGCGACAGTTT->TGTCGCCAGCGACAGTTTA
GGTCCCGTAGCGGACGCAT->GTCCCGTAGCGGACGCATC
CTACGCCTGAAGGTAAGTC->TACGCCTGAAGGTAAGTCC
ACTGAGGATACGCAACTCC->CTGAGGATACGCAACTCCC
TTCGCTTATCATTGCCTAA->TCGCTTATCATTGCCTAAC
AAAGTTCCTAGATTCATGC->AAGTTCCTAGATTCATGCG
TGTTCATTTCTTGTTAATT->GTTCATTTCTTGTTAATTG
GGGCCAGCCTTATGCAAGA->GGCCAGCCTTATGCAAGAC
TCAGAGGATGAAAGCCCTC->CAGAGGATGAAAGCCCTCT
ATGAAAGCCGAGTGTGGTG->TGAAAGCCGAGTGTGGTGC
TGGACAGACCCCAGGCTAT->GGACAGACCCCAGGCTATA
CGCCTCCTGCGAGCCTGCA->GCCTCCTGCGAGCCTGCAG
CCCAGGCTATAAAAGTATC->CCAGGCTATAAAAGTATCT
GTGGTAAAAGGATGGGTCT->TGGTAAAAGGATGGGTCTC
TGTTTCGCTTATCATTGCC->GTTTCGCTTATCATTGCCT
GTAAATCTAATTGAACTCA->TAAATCTAATTGAACTCAG
CCTTCCGTTAACGGTCCGA->CTTCCGTTAACGGTCCGAG
CATATGTTGCACTCGGTAG->ATATGTTGCACTCGGTAGT
TTCTGCGGGGAGTTCTGGT->TCTGCGGGGAGTTCTGGTG
GCCGAGTGTGGTGCAAGTA->CCGAGTGTGGTGCAAGTAC
GTACATTGCACACTAAGTA->TACATTGCACACTAAGTAG
GTTAACTCTATAATCTCCG->TTAACTCTATAATCTCCGC
GCCTGAAGGTAAGTCCGAG->CCTGAAGGTAAGTCCGAGT
TCTGTTCGCGCGCTACCAA->CTGTTCGCGCGCTACCAAG
TTTTACTGAGGATACGCAA->TTTACTGAGGATACGCAAC
CCTCCTGCGAGCCTGCAGG->CTCCTGCGAGCCTGCAGGA
TATGTGTCTTACCTCAACT->ATGTGTCTTACCTCAACTT
CCACATCAATAGTACATGG->CACATCAATAGTACATGGA
ACTCCCAGATCAGTCGCAA->CTCCCAGATCAGTCGCAAT
GGATCCACCGCGGTGCGGC->GATCCACCGCGGTGCGGCA
TAATTAACACTGGTATAGT->AATTAACACTGGTATAGTT
CATATTCACGCAAACCCAA->ATATTCACGCAAACCCAAA
CACCTCTTCACGCGACTGA->ACCTCTTCACGCGACTGAC
GCTTATCATTGCCTAACCA->CTTATCATTGCCTAACCAA
TCAGTTCTTCAACTCTTGA->CAGTTCTTCAACTCTTGAC
TAGGCGGGCCAATATAATG->AGGCGGGCCAATATAATGG
GACATAAGTCCTGCCGCAT->ACATAAGTCCTGCCGCATG
CGCGTCAGCTGTATTCACC->GCGTCAGCTGTATTCACCC
TGATTCCGGTTCTAAATAT->GATTCCGGTTCTAAATATC
GGAAGCCAGGTGTCTGCTT->GAAGCCAGGTGTCTGCTTG
AGTAAATCTAATTGAACTC->GTAAATCTAATTGAACTCA
CGGCCTTGCTTCTATGATG->GGCCTTGCTTCTATGATGC
CTTGACCGCCTCCTGCGAG->TTGACCGCCTCCTGCGAGC
AAGAGCGGAGTATCGGTCA->AGAGCGGAGTATCGGTCAT
GTTTACTTGTGCTTTACAT->TTTACTTGTGCTTTACATC
ATATCCACTTAAGTTAACT->TATCCACTTAAGTTAACTC
CCTCGCCAGCGTTTAAAAA->CTCGCCAGCGTTTAAAAAG
TCCGGAAAAACAAGTTGTA->CCGGAAAAACAAGTTGTAC
TCCTCTCTCGATTCCCGCA->CCTCTCTCGATTCCCGCAT
CTGGACAGACCCCAGGCTA->TGGACAGACCCCAGGCTAT
TTCATTGCTCTTTGTGCAG->TCATTGCTCTTTGTGCAGC
TATACTGCACCTAACCTTG->ATACTGCACCTAACCTTGA
ATTATGTTAGTACGTAGAC->TTATGTTAGTACGTAGACT
GTGGTCGAATAGACGCTAG->TGGTCGAATAGACGCTAGT
CTGGTTTCTGGCCTATACG->TGGTTTCTGGCCTATACGG
ACCTAGTGAAGCTCATCGG->CCTAGTGAAGCTCATCGGA
GGTGCAAGTACACCACCCA->GTGCAAGTACACCACCCAG
TCGCGAAAGGTCGGTGGCT->CGCGAAAGGTCGGTGGCTA
TGGCTAATTTCAGACTACT->GGCTAATTTCAGACTACTC
GCCAGGTGTCTGCTTGCAC->CCAGGTGTCTGCTTGCACA
AGCGGAGTATCGGTCATCG->GCGGAGTATCGGTCATCGA
CCAGGTGTCTGCTTGCACA->CAGGTGTCTGCTTGCACAT
GCCCTAGGGCAAAGAGCGG->CCCTAGGGCAAAGAGCGGA
TCTGCCGTTTTATTGAAGT->CTGCCGTTTTATTGAAGTG
TCGCTCGACCACGCGTCAG->CGCTCGACCACGCGTCAGC
AAGGAGTGTAAAAATGTGC->AGGAGTGTAAAAATGTGCC
CTACATTGTATTGGCCCAT->TACATTGTATTGGCCCATC
CCGCATCTGCTCATGTCGC->CGCATCTGCTCATGTCGCC
ATAATCTACGCCTGAAGGT->TAATCTACGCCTGAAGGTA
CTCGCCAGCGTTTAAAAAG->TCGCCAGCGTTTAAAAAGG
TCGAGGGTAGAATTGTCTG->CGAGGGTAGAATTGTCTGG
TGAAAGCCCTCTGCCGTTT->GAAAGCCCTCTGCCGTTTT
CTCAACTTTAGGCCAAGAT->TCAACTTTAGGCCAAGATT
GCGTGTTTCGCTTATCATT->CGTGTTTCGCTTATCATTG
CGTTAGGCTTCAGTATCTG->GTTAGGCTTCAGTATCTGC
AATAGGTTGAGTGACGGTG->ATAGGTTGAGTGACGGTGT
GGTCGGTAGGCGGGCCAAT->GTCGGTAGGCGGGCCAATA
CTCCGCCAACCACATATGT->TCCGCCAACCACATATGTT
GCCGCATGAAGCGCAGTTA->CCGCATGAAGCGCAGTTAC
CGCCACTCTCCCACTATTT->GCCACTCTCCCACTATTTT
ATTGCACACTAAGTAGCCT->TTGCACACTAAGTAGCCTA
GGCCTTGCTTCTATGATGC->GCCTTGCTTCTATGATGCC
CGGAAAGACTCAGATTGAT->GGAAAGACTCAGATTGATA
TTCATTTCTTGTTAATTGA->TCATTTCTTGTTAATTGAT
CCGCCAACCACATATGTTG->CGCCAACCACATATGTTGC
ACATTGCACACTAAGTAGC->CATTGCACACTAAGTAGCC
GTCCCGTAGCGGACGCATC->TCCCGTAGCGGACGCATCC
TTCTTGTTAATTGATTCCG->TCTTGTTAATTGATTCCGG
ACCTAACCTTGACCGCCTC->CCTAACCTTGACCGCCTCC,CCTAACCTTGACCGCCTCT,CCTAACCTTGACCGCCTCG,CCTAACCTTGACCGCCTCC
ATTTGCCGGGTAGTAAATC->TTTGCCGGGTAGTAAATCT
TCAGCGGTTCCCGACCGTC->CAGCGGTTCCCGACCGTCT
GTAACGCGTGTTTCGCTTA->TAACGCGTGTTTCGCTTAT
ATGAAAGCCCTCTGCCGTT->TGAAAGCCCTCTGCCGTTT
GTAAGCGGACCTAACCTTG->TAAGCGGACCTAACCTTGA
GTAATGAAAGCCGAGTGTG->TAATGAAAGCCGAGTGTGG
AGTGAAGCTCATCGGAGGC->GTGAAGCTCATCGGAGGCC
ATCTGTCGTTAGGCTTCAG->TCTGTCGTTAGGCTTCAGT
CTCAAGAAAGGGGCCAGCC->TCAAGAAAGGGGCCAGCCT
CGATTCCCGCATCTGCTCA->GATTCCCGCATCTGCTCAT
AACGCCAGCTGACGCGGAT->ACGCCAGCTGACGCGGATC
GTGGTCGTCAGCGGTTCCC->TGGTCGTCAGCGGTTCCCG
TATGCAAGACCTAACCTTG->ATGCAAGACCTAACCTTGA
AGGTCGGTGGCTATTAAGT->GGTCGGTGGCTATTAAGTC
AAGCCCTCTGCCGTTTTAT->AGCCCTCTGCCGTTTTATT
ATAATCTCCGCTCAGTGAA->TAATCTCCGCTCAGTGAAC
CCTATACGGGACTCCCAGA->CTATACGGGACTCCCAGAT
CAGCTTATATGTGTCTTAC->AGCTTATATGTGTCTTACC
CGCGCGCTACCAAGCTAGC->GCGCGCTACCAAGCTAGCC
AGGAAGCCAGGTGTCTGCT->GGAAGCCAGGTGTCTGCTT
ACGCATCCGAGCACAGAGT->CGCATCCGAGCACAGAGTC
GGAAGAGGTCATCCCACAT->GAAGAGGTCATCCCACATC
CAAGTTCCCTAACAAGGTT->AAGTTCCCTAACAAGGTTT
CTTCTCGATAATCTACGCC->TTCTCGATAATCTACGCCT
CCACATCTGTTCGCCAATT->CACATCTGTTCGCCAATTG
GTATTCACCCTCATCGGGT->TATTCACCCTCATCGGGTA
ACACCACCCAGCAAGTTCC->CACCACCCAGCAAGTTCCC
GCATCCGAGCACAGAGTCG->CATCCGAGCACAGAGTCGT
CGAAACATGGTTCCGGGCT->GAAACATGGTTCCGGGCTA
CTAAAAGGCTCAAGAAAGG->TAAAAGGCTCAAGAAAGGG
GGCTCAAGAAAGGGGCCAG->GCTCAAGAAAGGGGCCAGG
TCAGAATGTCGGCTCGAAT->CAGAATGTCGGCTCGAATT
TCAGTGTTCATTTCTTGTT->CAGTGTTCATTTCTTGTTA
TTGATTCCGGTTCTAAATA->TGATTCCGGTTCTAAATAT
TCGGCTTTGAGCCCTAGGG->CGGCTTTGAGCCCTAGGGC
GTCATCGTACATTGCACAC->TCATCGTACATTGCACACT
TGCAGGAAGCCAGGTGTCT->GCAGGAAGCCAGGTGTCTG
AAGACTCAGATTGATATTC->AGACTCAGATTGATATTCC
AGTCATCGTACATTGCACA->GTCATCGTACATTGCACAC
GTTTAAAAAGGCTTCTCGA->TTTAAAAAGGCTTCTCGAT
CGCGCTACCAAGCTAGCCC->GCGCTACCAAGCTAGCCCT
CAGACCCCAGGCTATAAAA->AGACCCCAGGCTATAAAAG
GCGGCAGTCGTGTCATGGA->CGGCAGTCGTGTCATGGAA
TGTCCCGGCAACCTAGTGA->GTCCCGGCAACCTAGTGAA
CTGCTCATGTCGCCAGCGA->TGCTCATGTCGCCAGCGAC
GCTCAAGAAAGGGGCCAGT->CTCAAGAAAGGGGCCAGTA
TTGCCTAACCAAGTTGTGG->TGCCTAACCAAGTTGTGGC
GCCGGGTAGTAAATCTAAT->CCGGGTAGTAAATCTAATT
CCTAACCTTGACCGCCTCT->CTAACCTTGACCGCCTCTG
ACCACCCAGCAAGTTCCCT->CCACCCAGCAAGTTCCCTA
GCTCAGTGAACAACCAATA->CTCAGTGAACAACCAATAC
TACCTCAACTTTAGGCCAA->ACCTCAACTTTAGGCCAAG
GGTAGTAAATCTAATTGAA->GTAGTAAATCTAATTGAAC
TCGTTAGGCTTCAGTATCT->CGTTAGGCTTCAGTATCTG
CCTCTGACCGATTCTCGGC->CTCTGACCGATTCTCGGCT
TTAGAGTCGCGAAAGGTCG->TAGAGTCGCGAAAGGTCGG
CTTGACCGCCTCGCTTGAA->TTGACCGCCTCGCTTGAAG
TGAAGGTAAGTCCGAGTTC->GAAGGTAAGTCCGAGTTCG
GAAAGGGGCCAGGCAGTAA->AAAGGGGCCAGGCAGTAAG
ATATTCTGCGGGGAGTTCT->TATTCTGCGGGGAGTTCTG
TCATCCCACATCAATAGTA->CATCCCACATCAATAGTAC
AGTTCGCTATACGCTCAAG->GTTCGCTATACGCTCAAGA
CTAACAAGGTTTTAGTCCC->TAACAAGGTTTTAGTCCCT
TCCGGGCTACTACGGGAAA->CCGGGCTACTACGGGAAAG
GTAGGAGCCCTCAGAGGAT->TAGGAGCCCTCAGAGGATG
AGTGACGGTGTGGAATGAC->GTGACGGTGTGGAATGACA
CGGACCTAACCTTGACCGC->GGACCTAACCTTGACCGCC
AATCGTCCATCCGTGTGGT->ATCGTCCATCCGTGTGGTC
AGCCTATTCCAGGTCAATC->GCCTATTCCAGGTCAATCT
CACCCTCATCGGGTAGGAG->ACCCTCATCGGGTAGGAGC
AAAAGGATGGGTCTCGCTG->AAAGGATGGGTCTCGCTGT
CAATAGTACATGGATTCAT->AATAGTACATGGATTCATA
GGCTATAAAAGTATCTGAT->GCTATAAAAGTATCTGATT
TAATCTCCGCTCAGTGAAC->AATCTCCGCTCAGTGAACA
GCAAGTACACCACCCAGCA->CAAGTACACCACCCAGCAA
AGCGGTTCCCGACCGTCTG->GCGGTTCCCGACCGTCTGG
TCGGTCATCGATAAATGCT->CGGTCATCGATAAATGCTG
GGCCAGCCTTATGCAAGAC->GCCAGCCTTATGCAAGACC
ACCCAAATAATTAACACTG->CCCAAATAATTAACACTGG
AATGGGCCAATAGGTTGAG->ATGGGCCAATAGGTTGAGT
GGTCATCCCACATCAATAG->GTCATCCCACATCAATAGT
GAAGAAATCATATTCACGC->AAGAAATCATATTCACGCA
CTGTCACATCTCTGTGCTG->TGTCACATCTCTGTGCTGG
ACCAAGTTGTGGCGACGTA->CCAAGTTGTGGCGACGTAC
AACTTTAGGCCAAGATTCC->ACTTTAGGCCAAGATTCCT
GCTAGCCCTATCACCCCGG->CTAGCCCTATCACCCCGGA
TTGTACATATACAACGCCA->TGTACATATACAACGCCAG
GCGCCCAGGGTCCTCTCTC->CGCCCAGGGTCCTCTCTCG
CGGCAACCTAGTGAAGCTC->GGCAACCTAGTGAAGCTCA
TGCTCACCTCTTCACGCGA->GCTCACCTCTTCACGCGAC
AGACCTAACCTTGACCGCC->GACCTAACCTTGACCGCCT
ACCAATACCGCCACCCTCG->CCAATACCGCCACCCTCGC
AAAGGGGCCAGACGCCTCA->AAGGGGCCAGACGCCTCAA
TCCTTCCGTTAACGGTCCG->CCTTCCGTTAACGGTCCGA
TTTTAGTCCCTAACTAACC->TTTAGTCCCTAACTAACCG
CCCTCATCGGGTAGGAGCC->CCTCATCGGGTAGGAGCCC
GCCGGAATTTCCATGTTCA->CCGGAATTTCCATGTTCAT
AGCTTATATGTGTCTTACC->GCTTATATGTGTCTTACCT
ATCATTGCCTAACCAAGTT->TCATTGCCTAACCAAGTTG
ACGTAGACTTCGTATTTGC->CGTAGACTTCGTATTTGCC
AAGATGGTCGGTAGGCGGG->AGATGGTCGGTAGGCGGGC
AGAGTCGTCCGGGGGCAAG->GAGTCGTCCGGGGGCAAGT
TGGTAAAAGGATGGGTCTC->GGTAAAAGGATGGGTCTCG
AAGTAATGAAAGCCGAGTG->AGTAATGAAAGCCGAGTGT
TATACGCTCAAGAAAGGGG->ATACGCTCAAGAAAGGGGC
CAGGTGTCTGCTTGCACAT->AGGTGTCTGCTTGCACATT
ATTATTACGACATAAGTCC->TTATTACGACATAAGTCCT
TCTAAATATCCACTTAAGT->CTAAATATCCACTTAAGTT
GCAGTAAGCGGACCTAACC->CAGTAAGCGGACCTAACCT
GGGCTACTACGGGAAAGTT->GGCTACTACGGGAAAGTTC
ATTAAGGGACAACTACATT->TTAAGGGACAACTACATTG
TAAATATCCACTTAAGTTA->AAATATCCACTTAAGTTAA
CCAGCAAGTTCCCTAACAA->CAGCAAGTTCCCTAACAAG
AGTTGTACATATACAACGC->GTTGTACATATACAACGCC
TCTTACCTCAACTTTAGGC->CTTACCTCAACTTTAGGCC
GGTGGCTATTAAGTCTGTT->GTGGCTATTAAGTCTGTTC
GGGCCAATAGGTTGAGTGA->GGCCAATAGGTTGAGTGAC
ATAGGTTGAGTGACGGTGT->TAGGTTGAGTGACGGTGTG
AATCTAATTGAACTCAGTT->ATCTAATTGAACTCAGTTC
TCGAATAGACGCTAGTCCC->CGAATAGACGCTAGTCCCC
TCTGGTGTCCCGGCAACCT->CTGGTGTCCCGGCAACCTA
TCCCCTCGTTTAAACCACA->CCCCTCGTTTAAACCACAT
GCGGATCCACCGCGGTGCG->CGGATCCACCGCGGTGCGG
CCCGACCGTCTGGTACCAA->CCGACCGTCTGGTACCAAC
AACCTCGCCAGCGTTTAAA->ACCTCGCCAGCGTTTAAAA
TTCCCGCATCTGCTCATGT->TCCCGCATCTGCTCATGTC
GTCAGTGTTCATTTCTTGT->TCAGTGTTCATTTCTTGTT
ACGCGGATCCACCGCGGTG->CGCGGATCCACCGCGGTGC
ATTTCAGACTACTCTAAGT->TTTCAGACTACTCTAAGTA
CCGCCTCGCTTGAAGAAAT->CGCCTCGCTTGAAGAAATC
TCTGGTACCAACAACGGCC->CTGGTACCAACAACGGCCT
GAATAGACGCTAGTCCCCC->AATAGACGCTAGTCCCCCA
CCAGTCAGTGTTCATTTCT->CAGTCAGTGTTCATTTCTT
AGAGTACCAAAGATGGTCG->GAGTACCAAAGATGGTCGG
CCTTGACCGCCTCTGACCA->CTTGACCGCCTCTGACCAC
AGCTATACCTCCATATGCT->GCTATACCTCCATATGCTC
ACCGATTCTCGGCTTTGAG->CCGATTCTCGGCTTTGAGC
AGACTTCGTATTTGCCGGG->GACTTCGTATTTGCCGGGT
ATTGCCTAACCAAGTTGTG->TTGCCTAACCAAGTTGTGG
GAGCACAGAGTCGTCCGGG->AGCACAGAGTCGTCCGGGG
GACCGATTCTCGGCTTTGA->ACCGATTCTCGGCTTTGAG
TTTTCCACCCCATCCGAGG->TTTCCACCCCATCCGAGGA
GTCGAATAGACGCTAGTCC->TCGAATAGACGCTAGTCCC
CCTTGCTTCTATGATGCCG->CTTGCTTCTATGATGCCGT
ATATGTTGCACTCGGTAGT->TATGTTGCACTCGGTAGTC
ATTGGCCCATCTAAATCCG->TTGGCCCATCTAAATCCGG
GGGGCCAGGCAGTAAGCGG->GGGCCAGGCAGTAAGCGGA
AAGTATCTGATTAGAGTCG->AGTATCTGATTAGAGTCGC
ACTAAGTAGCCTATTCCAG->CTAAGTAGCCTATTCCAGG
GGGTAGTAAATCTAATTGA->GGTAGTAAATCTAATTGAA
CATGTCGCCAGCGACAGTT->ATGTCGCCAGCGACAGTTT
CATTGTATTGGCCCATCTA->ATTGTATTGGCCCATCTAA
TATTTGCCGGGTAGTAAAT->ATTTGCCGGGTAGTAAATC
AAAGAGCGGAGTATCGGTC->AAGAGCGGAGTATCGGTCA
TTTCCATGTTCATTGCTCT->TTCCATGTTCATTGCTCTT
AGGAGCCCTCAGAGGATGA->GGAGCCCTCAGAGGATGAA
GCTAGCTCAAGAAAGGGGC->CTAGCTCAAGAAAGGGGCC
ATAGCGTAACGCGTGTTTC->TAGCGTAACGCGTGTTTCG
TAAGTAATGAAAGCCGAGT->AAGTAATGAAAGCCGAGTG
GAGGCCAGTTGCTAGCCAT->AGGCCAGTTGCTAGCCATC
CTATGATGCCGTTATAGAG->TATGATGCCGTTATAGAGT
TTTACATCCTTCCGTTAAC->TTACATCCTTCCGTTAACG
AATTGAACTCAGTTCTTCA->ATTGAACTCAGTTCTTCAA
CAGCAAGTTCCCTAACAAG->AGCAAGTTCCCTAACAAGG
CCTAGATTCATGCGCTAGC->CTAGATTCATGCGCTAGCT
ACGGGACTCCCAGATCAGT->CGGGACTCCCAGATCAGTC
GCTCATGTCGCCAGCGACA->CTCATGTCGCCAGCGACAG
GGAATTTCCATGTTCATTG->GAATTTCCATGTTCATTGC
ACTGCACCTAACCTTGACC->CTGCACCTAACCTTGACCG
GGACAACTACATTGTATTG->GACAACTACATTGTATTGG
CACTGCTTGGTGGTCGTCA->ACTGCTTGGTGGTCGTCAG
TTATGCAAGACCTAACCTT->TATGCAAGACCTAACCTTG
AACTCTATAATCTCCGCTC->ACTCTATAATCTCCGCTCA
CCCAGATCAGTCGCAATCA->CCAGATCAGTCGCAATCAG
GACAACTACATTGTATTGG->ACAACTACATTGTATTGGC
CGCCAACCACATATGTTGC->GCCAACCACATATGTTGCA
GATCAGTCGCAATCAGAAT->ATCAGTCGCAATCAGAATG
GCTCAAGAAAGGGGCCAGA->CTCAAGAAAGGGGCCAGAC
CCGCCTCCCGTTTGGCATG->CGCCTCCCGTTTGGCATGG
CCTAACAAGGTTTTAGTCC->CTAACAAGGTTTTAGTCCC
AAGAAAGGGGCCAGGCAGT->AGAAAGGGGCCAGGCAGTA
CCTCCCGTTTGGCATGGTG->CTCCCGTTTGGCATGGTGT
CGTTATAGAGTACCAAAGA->GTTATAGAGTACCAAAGAT
ACGGGAAAGTTCCTAGATT->CGGGAAAGTTCCTAGATTC
GTGGCTATTAAGTCTGTTC->TGGCTATTAAGTCTGTTCG
CTGGGTCCCGTAGCGGACG->TGGGTCCCGTAGCGGACGC
TGTATTCACCCTCATCGGG->GTATTCACCCTCATCGGGT
ACAACGGCCTTGCTTCTAT->CAACGGCCTTGCTTCTATG
AGTCTGTTCGCGCGCTACC->GTCTGTTCGCGCGCTACCA
CATTGCTCTTTGTGCAGCT->ATTGCTCTTTGTGCAGCTT
ATATCAGCTATGTCACATA->TATCAGCTATGTCACATAT
CCCAGGGTCCTCTCTCGAT->CCAGGGTCCTCTCTCGATT
TCGCGCGCTACCAAGCTAG->CGCGCGCTACCAAGCTAGC
AAGGGGCCAGGCAGTAAGC->AGGGGCCAGGCAGTAAGCG
GCAACTCCCGTAGCTATAC->CAACTCCCGTAGCTATACC
TCATATCAGCTATGTCACA->CATATCAGCTATGTCACAT
TAGGCCAAGATTCCTTATC->AGGCCAAGATTCCTTATCG
GATGAAAGCCCTCTGCCGT->ATGAAAGCCCTCTGCCGTT
GACGGTGTGGAATGACAAC->ACGGTGTGGAATGACAACC
GGTCCTCTCTCGATTCCCG->GTCCTCTCTCGATTCCCGC
GTATATATTATTACGACAT->TATATATTATTACGACATA
TATCGGTCATCGATAAATG->ATCGGTCATCGATAAATGC
TTACGACATAAGTCCTGCC->TACGACATAAGTCCTGCCG
ATAAAAGTATCTGATTAGA->TAAAAGTATCTGATTAGAG
GCTATAAAAGTATCTGATT->CTATAAAAGTATCTGATTA
TACTACGGGAAAGTTCCTA->ACTACGGGAAAGTTCCTAG
AACACTGGTATAGTTATTG->ACACTGGTATAGTTATTGA
TTGAAGTGGTAAAAGGATG->TGAAGTGGTAAAAGGATGG
CCTCAATAACCTAACCTTG->CTCAATAACCTAACCTTGA
ATACCGAAACATGGTTCCG->TACCGAAACATGGTTCCGG
TAACACTGGTATAGTTATT->AACACTGGTATAGTTATTG
TGTCTTACCTCAACTTTAG->GTCTTACCTCAACTTTAGG
GAAAGGGGCCAGACGCCTC->AAAGGGGCCAGACGCCTCA
CCGATTCTCGGCTTTGAGC->CGATTCTCGGCTTTGAGCC
AATAGCGTAACGCGTGTTT->ATAGCGTAACGCGTGTTTC
GACGCCTCAATAACCTAAC->ACGCCTCAATAACCTAACC
CGACATAAGTCCTGCCGCA->GACATAAGTCCTGCCGCAT
CGGAAAAACAAGTTGTACA->GGAAAAACAAGTTGTACAT
AATTGATTCCGGTTCTAAA->ATTGATTCCGGTTCTAAAT
GATAAATGCTGTCATATCA->ATAAATGCTGTCATATCAG
GATTCCGGTTCTAAATATC->ATTCCGGTTCTAAATATCC
TGTGCCTTGGACTAGCGCT->GTGCCTTGGACTAGCGCTA
TCACCCTCATCGGGTAGGA->CACCCTCATCGGGTAGGAG
GCGGACCTAACCTTGACCG->CGGACCTAACCTTGACCGC
ATTGAACTCAGTTCTTCAA->TTGAACTCAGTTCTTCAAC
TGTTAATTGATTCCGGTTC->GTTAATTGATTCCGGTTCT
CTCGACCACGCGTCAGCTG->TCGACCACGCGTCAGCTGT
ATCAGAATGTCGGCTCGAA->TCAGAATGTCGGCTCGAAT
TTGCTCTTTGTGCAGCTTA->TGCTCTTTGTGCAGCTTAT
CCGGAAAGACTCAGATTGA->CGGAAAGACTCAGATTGAT
ACCTTGACCGCCTCTGACC->CCTTGACCGCCTCTGACCA
CCAATAGGTTGAGTGACGG->CAATAGGTTGAGTGACGGT
GAGCCCTAGGGCAAAGAGC->AGCCCTAGGGCAAAGAGCG
GCCAGCGTTTAAAAAGGCT->CCAGCGTTTAAAAAGGCTT
CCAAGTTGTGGCGACGTAC->CAAGTTGTGGCGACGTACG
ATCGTCCATCCGTGTGGTC->TCGTCCATCCGTGTGGTCG
TTCTAAATATCCACTTAAG->TCTAAATATCCACTTAAGT
AGGGGCCAGGCAGTAAGCG->GGGGCCAGGCAGTAAGCGG
CTAAGTAGCCTATTCCAGG->TAAGTAGCCTATTCCAGGT
TATCTGATTAGAGTCGCGA->ATCTGATTAGAGTCGCGAA
TGACCACTAGCGCACAAGA->GACCACTAGCGCACAAGAA
CATTTCTTGTTAATTGATT->ATTTCTTGTTAATTGATTC
CCAGCCTTATGCAAGACCT->CAGCCTTATGCAAGACCTA
TATTGAAGTGGTAAAAGGA->ATTGAAGTGGTAAAAGGAT
CCGTTAACGGTCCGAGTCA->CGTTAACGGTCCGAGTCAT
CGGGCCAATATAATGGGCC->GGGCCAATATAATGGGCCA
TAAGCGGACCTAACCTTGA->AAGCGGACCTAACCTTGAC
AAGGTTTTAGTCCCTAACT->AGGTTTTAGTCCCTAACTA
CTCCCGTAGCTATACCTCC->TCCCGTAGCTATACCTCCA
TGTGGCGACGTACGATACA->GTGGCGACGTACGATACAA
CCGTAGCGGACGCATCCGA->CGTAGCGGACGCATCCGAG
TCTCTCGATTCCCGCATCT->CTCTCGATTCCCGCATCTG
ATACTGCACCTAACCTTGA->TACTGCACCTAACCTTGAC
CAACTCCCGTAGCTATACC->AACTCCCGTAGCTATACCT
TGCTAGCCATCATCAAAAG->GCTAGCCATCATCAAAAGG
TCACATATCTGTCGTTAGG->CACATATCTGTCGTTAGGC
ACGTACGATACAATAATCT->CGTACGATACAATAATCTG
GCCAGACGCCTCAATAACC->CCAGACGCCTCAATAACCT
CGCGCCCAGGGTCCTCTCT->GCGCCCAGGGTCCTCTCTC
GTCGTCAGCGGTTCCCGAC->TCGTCAGCGGTTCCCGACC
TCCCGTTACGGAAGGATCT->CCCGTTACGGAAGGATCTG
TTACGCCACTCTCCCACTA->TACGCCACTCTCCCACTAT
ACCTTGACCGCCTCGCTTG->CCTTGACCGCCTCGCTTGA
CCAGCGTTTAAAAAGGCTT->CAGCGTTTAAAAAGGCTTC
CAAGTTGTGGCGACGTACG->AAGTTGTGGCGACGTACGA
TGGTGGTCGTCAGCGGTTC->GGTGGTCGTCAGCGGTTCC
GTTATAGAGTACCAAAGAT->TTATAGAGTACCAAAGATG
GCATGGTGTATATATTATT->CATGGTGTATATATTATTA
TTCCCGTTACGGAAGGATC->TCCCGTTACGGAAGGATCT
CAGTCAGTGTTCATTTCTT->AGTCAGTGTTCATTTCTTG
TAATTGATTCCGGTTCTAA->AATTGATTCCGGTTCTAAA
ATCTCCGCTCAGTGAACAA->TCTCCGCTCAGTGAACAAC
AATTAACACTGGTATAGTT->ATTAACACTGGTATAGTTA
GGCCAATAGGTTGAGTGAC->GCCAATAGGTTGAGTGACG
CTCTTGACCTCCGCCAACC->TCTTGACCTCCGCCAACCA
CCCATCCGAGGAAGAGGTC->CCATCCGAGGAAGAGGTCA
TTGAGCCCTAGGGCAAAGA->TGAGCCCTAGGGCAAAGAG
TGGTTCCGGGCTACTACGG->GGTTCCGGGCTACTACGGG
CGGCTCGAATTATGTTAGT->GGCTCGAATTATGTTAGTA
CTCCCGTTTGGCATGGTGT->TCCCGTTTGGCATGGTGTA
GCAAGTTCCCTAACAAGGT->CAAGTTCCCTAACAAGGTT
CCACCGCGGTGCGGCAGTC->CACCGCGGTGCGGCAGTCG
ATCACCCCGGAAAGACTCA->TCACCCCGGAAAGACTCAG
TACAATAATCTGGACAGAC->ACAATAATCTGGACAGACC
TGAAGAAATCATATTCACG->GAAGAAATCATATTCACGC
GGCAGTCGTGTCATGGAAT->GCAGTCGTGTCATGGAATA
CCCGCATCTGCTCATGTCG->CCGCATCTGCTCATGTCGC
ACGCTCAAGAAAGGGGCCA->CGCTCAAGAAAGGGGCCAG
CCCTCTGCCGTTTTATTGA->CCTCTGCCGTTTTATTGAA
AATAACCTAACCTTGACCG->ATAACCTAACCTTGACCGC
TCTAATTGAACTCAGTTCT->CTAATTGAACTCAGTTCTT
CGAGTCATATTCTGCGGGG->GAGTCATATTCTGCGGGGA
CCAACAACGGCCTTGCTTC->CAACAACGGCCTTGCTTCT
TTGACCGCCTCGCTTGAAG->TGACCGCCTCGCTTGAAGA
GTGTATATATTATTACGAC->TGTATATATTATTACGACA
ACCGTCTGGTACCAACAAC->CCGTCTGGTACCAACAACG
CCTATCACCCCGGAAAGAC->CTATCACCCCGGAAAGACT
TGCCGTTTTATTGAAGTGG->GCCGTTTTATTGAAGTGGT
GACCTAACCTTGACCGCCT->ACCTAACCTTGACCGCCTC,ACCTAACCTTGACCGCCTC
AAAGGATGGGTCTCGCTGT->AAGGATGGGTCTCGCTGTC
TATTCACCCTCATCGGGTA->ATTCACCCTCATCGGGTAG
TGCCTAACCAAGTTGTGGC->GCCTAACCAAGTTGTGGCG
GCTATACCTCCATATGCTC->CTATACCTCCATATGCTCA
AGTATCTGCCGGAATTTCC->GTATCTGCCGGAATTTCCA
ACAATAATCTGGACAGACC->CAATAATCTGGACAGACCC
CGCACAAGAAATCCCCTTC->GCACAAGAAATCCCCTTCC
TTTATTGAAGTGGTAAAAG->TTATTGAAGTGGTAAAAGG
CTGTCATATCAGCTATGTC->TGTCATATCAGCTATGTCA
TTGCACTCGGTAGTCCCCT->TGCACTCGGTAGTCCCCTC
GACCGCCTCCCGTTTGGCA->ACCGCCTCCCGTTTGGCAT
GGAAGGATCTGTCACATCT->GAAGGATCTGTCACATCTC
GTCTGCTTGCACATTTCCT->TCTGCTTGCACATTTCCTA
ATCTACGCCTGAAGGTAAG->TCTACGCCTGAAGGTAAGT
CAGCGACAGTTTACTTGTG->AGCGACAGTTTACTTGTGC
TTGACCGCCTCTGACCACT->TGACCGCCTCTGACCACTA
CGAGGAAGAGGTCATCCCA->GAGGAAGAGGTCATCCCAC
AGTGTTCATTTCTTGTTAA->GTGTTCATTTCTTGTTAAT
CTGCCGTTTTATTGAAGTG->TGCCGTTTTATTGAAGTGG
CGCGACTGACATTAAGGGA->GCGACTGACATTAAGGGAC
ACTCGGTAGTCCCCTCGTT->CTCGGTAGTCCCCTCGTTT
CAACCAATACCGCCACCCT->AACCAATACCGCCACCCTC
TTTCTGGCCTATACGGGAC->TTCTGGCCTATACGGGACT
GTTGCTAGCCATCATCAAA->TTGCTAGCCATCATCAAAA
TGCTGGTTTCTGGCCTATA->GCTGGTTTCTGGCCTATAC
AGTACACCACCCAGCAAGT->GTACACCACCCAGCAAGTT
GCAAACCCAAATAATTAAC->CAAACCCAAATAATTAACA
GGAAAAACAAGTTGTACAT->GAAAAACAAGTTGTACATA
TTTAAACCACATCTGTTCG->TTAAACCACATCTGTTCGC
TTCCACCCCATCCGAGGAA->TCCACCCCATCCGAGGAAG
CGGTCATCGATAAATGCTG->GGTCATCGATAAATGCTGT
CTGTTCGCCAATTGGCGGT->TGTTCGCCAATTGGCGGTC
GCGACGTACGATACAATAA->CGACGTACGATACAATAAT
TGTCATATCAGCTATGTCA->GTCATATCAGCTATGTCAC
CATCGGAGGCCAGTTGCTA->ATCGGAGGCCAGTTGCTAG
AAGTTCCTAGATTCATGCG->AGTTCCTAGATTCATGCGC
CAGAGTCGTCCGGGGGCAA->AGAGTCGTCCGGGGGCAAG
GAAGCGCAGTTACGCCACT->AAGCGCAGTTACGCCACTC
TCATTGCCTAACCAAGTTG->CATTGCCTAACCAAGTTGT
CGCCAGCTGACGCGGATCC->GCCAGCTGACGCGGATCCA
AATCTTTCCGCATTATGCT->ATCTTTCCGCATTATGCTC
CCATCCGTGTGGTCGAATA->CATCCGTGTGGTCGAATAG
TAGCCCTATCACCCCGGAA->AGCCCTATCACCCCGGAAA
ACAACCTCTGACCGATTCT->CAACCTCTGACCGATTCTC
ACTAGCGCTAAAAGGCTCA->CTAGCGCTAAAAGGCTCAA
CTACTCTAAGTAATGAAAG->TACTCTAAGTAATGAAAGC
GCGACAGTTTACTTGTGCT->CGACAGTTTACTTGTGCTT
CTAACCTTGACCGCCTCCC->TAACCTTGACCGCCTCCCG
TGCTGTCATATCAGCTATG->GCTGTCATATCAGCTATGT
CGACTGACATTAAGGGACA->GACTGACATTAAGGGACAA
CGCGAAAGGTCGGTGGCTA->GCGAAAGGTCGGTGGCTAT
GCAGGAAGCCAGGTGTCTG->CAGGAAGCCAGGTGTCTGC
GATGGTCGGTAGGCGGGCC->ATGGTCGGTAGGCGGGCCA
CTTGAAGAAATCATATTCA->TTGAAGAAATCATATTCAC
AGTCACTGCTTGGTGGTCG->GTCACTGCTTGGTGGTCGT
GACCACTAGCGCACAAGAA->ACCACTAGCGCACAAGAAA
CTGGTGTCCCGGCAACCTA->TGGTGTCCCGGCAACCTAG
GAAAGGGGCCAGCCTTATG->AAAGGGGCCAGCCTTATGC
AAGACCTAACCTTGACCGC->AGACCTAACCTTGACCGCC
ACTACGGGAAAGTTCCTAG->CTACGGGAAAGTTCCTAGA
CACCCAGCAAGTTCCCTAA->ACCCAGCAAGTTCCCTAAC
ATTTTCCACCCCATCCGAG->TTTTCCACCCCATCCGAGG
AGGATGAAAGCCCTCTGCC->GGATGAAAGCCCTCTGCCG
TGAACTCAGTTCTTCAACT->GAACTCAGTTCTTCAACTC
CATGTTCATTGCTCTTTGT->ATGTTCATTGCTCTTTGTG
GCGAGCCTGCAGGAAGCCA->CGAGCCTGCAGGAAGCCAG
TACGCCACTCTCCCACTAT->ACGCCACTCTCCCACTATT
TACAACGCCAGCTGACGCG->ACAACGCCAGCTGACGCGG
TGTGGTGCAAGTACACCAC->GTGGTGCAAGTACACCACC
TATCATTGCCTAACCAAGT->ATCATTGCCTAACCAAGTT
ATCGAAGCTTTGATCTCGA->TCGAAGCTTTGATCTCGAG
CTGCACCTAACCTTGACCG->TGCACCTAACCTTGACCGC
TTGGCCCATCTAAATCCGG->TGGCCCATCTAAATCCGGA
TCCCGTAGCTATACCTCCA->CCCGTAGCTATACCTCCAT
CGCTATACGCTCAAGAAAG->GCTATACGCTCAAGAAAGG
GGCTTTGAGCCCTAGGGCA->GCTTTGAGCCCTAGGGCAA
CCGAGCACAGAGTCGTCCG->CGAGCACAGAGTCGTCCGG
ACATATACAACGCCAGCTG->CATATACAACGCCAGCTGA
TGCTTTACATCCTTCCGTT->GCTTTACATCCTTCCGTTA
TAGCGCACAAGAAATCCCC->AGCGCACAAGAAATCCCCT
AATCTGGACAGACCCCAGG->ATCTGGACAGACCCCAGGC
TACGATACAATAATCTGGA->ACGATACAATAATCTGGAC
GCACACTAAGTAGCCTATT->CACACTAAGTAGCCTATTC
ATTCCGGTTCTAAATATCC->TTCCGGTTCTAAATATCCA
TTTTTACTGAGGATACGCA->TTTTACTGAGGATACGCAA
GACAACCTCTGACCGATTC->ACAACCTCTGACCGATTCT
TTCGTATTTGCCGGGTAGT->TCGTATTTGCCGGGTAGTA
GACAGACCCCAGGCTATAA->ACAGACCCCAGGCTATAAA
GATTCATGCGCTAGCTCAA->ATTCATGCGCTAGCTCAAG
GCGCACAAGAAATCCCCTT->CGCACAAGAAATCCCCTTC
TATAAAAGTATCTGATTAG->ATAAAAGTATCTGATTAGA
GGGCCAGTAGTATACTGCA->GGCCAGTAGTATACTGCAC
AGATTCATGCGCTAGCTCA->GATTCATGCGCTAGCTCAA
TCATATTCTGCGGGGAGTT->CATATTCTGCGGGGAGTTC
TGTACATATACAACGCCAG->GTACATATACAACGCCAGC
CTAGGGCAAAGAGCGGAGT->TAGGGCAAAGAGCGGAGTA
CGTCCATCCGTGTGGTCGA->GTCCATCCGTGTGGTCGAA
GCCCATCTAAATCCGGAAA->CCCATCTAAATCCGGAAAA
CTCCTGCGAGCCTGCAGGA->TCCTGCGAGCCTGCAGGAA
TATAGAGTACCAAAGATGG->ATAGAGTACCAAAGATGGT
GGTGTCTGCTTGCACATTT->GTGTCTGCTTGCACATTTC
CCATCCGAGGAAGAGGTCA->CATCCGAGGAAGAGGTCAT
TTGCACACTAAGTAGCCTA->TGCACACTAAGTAGCCTAT
GGTAGAATTGTCTGGGTCC->GTAGAATTGTCTGGGTCCC
TGCGCTAGCTCAAGAAAGG->GCGCTAGCTCAAGAAAGGG
TATGATGCCGTTATAGAGT->ATGATGCCGTTATAGAGTA
CTAGCGCACAAGAAATCCC->TAGCGCACAAGAAATCCCC
CCTCTCTCGATTCCCGCAT->CTCTCTCGATTCCCGCATC
ACGCGACTGACATTAAGGG->CGCGACTGACATTAAGGGA
TAGACGCTAGTCCCCCAGT->AGACGCTAGTCCCCCAGTC
CCCCTTCCCTATTTTCCAC->CCCTTCCCTATTTTCCACC
CTTATATGTGTCTTACCTC->TTATATGTGTCTTACCTCA
CCTAGTCACTGCTTGGTGG->CTAGTCACTGCTTGGTGGT
GCACATTTCCTAGTCACTG->CACATTTCCTAGTCACTGC
CGCTAGTCCCCCAGTCAGT->GCTAGTCCCCCAGTCAGTG
GTCATATTCTGCGGGGAGT->TCATATTCTGCGGGGAGTT
CCTAGGGCAAAGAGCGGAG->CTAGGGCAAAGAGCGGAGT
AGTCGCAATCAGAATGTCG->GTCGCAATCAGAATGTCGG
CATTGCACACTAAGTAGCC->ATTGCACACTAAGTAGCCT
AGCCGAGTGTGGTGCAAGT->GCCGAGTGTGGTGCAAGTA
CAGCGGTTCCCGACCGTCT->AGCGGTTCCCGACCGTCTG
CACTCGGTAGTCCCCTCGT->ACTCGGTAGTCCCCTCGTT
GACTCAGATTGATATTCCC->ACTCAGATTGATATTCCCG
GTCATATCAGCTATGTCAC->TCATATCAGCTATGTCACA
TTATTGAAGTGGTAAAAGG->TATTGAAGTGGTAAAAGGA
TGAGCCCTAGGGCAAAGAG->GAGCCCTAGGGCAAAGAGC
GTCGTTAGGCTTCAGTATC->TCGTTAGGCTTCAGTATCT
AAATGCTGTCATATCAGCT->AATGCTGTCATATCAGCTA
ATCTGCCGGAATTTCCATG->TCTGCCGGAATTTCCATGT
AGTACGTAGACTTCGTATT->GTACGTAGACTTCGTATTT
TTTAAAAAGGCTTCTCGAT->TTAAAAAGGCTTCTCGATA
TGAGGAATCGTCCATCCGT->GAGGAATCGTCCATCCGTG
TCTGATTAGAGTCGCGAAA->CTGATTAGAGTCGCGAAAG
AGCCAGGTGTCTGCTTGCA->GCCAGGTGTCTGCTTGCAC
ATACCTCCATATGCTCAAG->TACCTCCATATGCTCAAGA
TATTGAGGAATCGTCCATC->ATTGAGGAATCGTCCATCC
GCTTTGAGCCCTAGGGCAA->CTTTGAGCCCTAGGGCAAA
AACAAGGTTTTAGTCCCTA->ACAAGGTTTTAGTCCCTAA
CTAGCTCAAGAAAGGGGCC->TAGCTCAAGAAAGGGGCCA
ATTATGCTCACCTCTTCAC->TTATGCTCACCTCTTCACG
GACTGACATTAAGGGACAA->ACTGACATTAAGGGACAAC
GAATAGCGTAACGCGTGTT->AATAGCGTAACGCGTGTTT
TAACCTAACCTTGACCGCC->AACCTAACCTTGACCGCCT
TTCAACTCTTGACCTCCGC->TCAACTCTTGACCTCCGCC
TTGACCGCCTCCCGTTTGG->TGACCGCCTCCCGTTTGGC
GGAGTATCGGTCATCGATA->GAGTATCGGTCATCGATAA
GGTCAATCTTTCCGCATTA->GTCAATCTTTCCGCATTAT
TTAACACTGGTATAGTTAT->TAACACTGGTATAGTTATT
ATTTCCTAGTCACTGCTTG->TTTCCTAGTCACTGCTTGG
CAACTCTTGACCTCCGCCA->AACTCTTGACCTCCGCCAA
AAGGCTCAAGAAAGGGGCC->AGGCTCAAGAAAGGGGCCA
GCAATCAGAATGTCGGCTC->CAATCAGAATGTCGGCTCG
TGCTTCTATGATGCCGTTA->GCTTCTATGATGCCGTTAT
AAGGATCTGTCACATCTCT->AGGATCTGTCACATCTCTG
CGGTTCCCGACCGTCTGGT->GGTTCCCGACCGTCTGGTA
CTCAAGAAAGGGGCCAGGC->TCAAGAAAGGGGCCAGGCA
AGTAGTATACTGCACCTAA->GTAGTATACTGCACCTAAC
GCATCTGCTCATGTCGCCA->CATCTGCTCATGTCGCCAG
CAGTGAACAACCAATACCG->AGTGAACAACCAATACCGC
CCGTCTGGTACCAACAACG->CGTCTGGTACCAACAACGG
TTCCGTTAACGGTCCGAGT->TCCGTTAACGGTCCGAGTC
AGCCATCATCAAAAGGAGT->GCCATCATCAAAAGGAGTG
CCCTCGTTTAAACCACATC->CCTCGTTTAAACCACATCT
CATCTAAATCCGGAAAAAC->ATCTAAATCCGGAAAAACA
TACATATACAACGCCAGCT->ACATATACAACGCCAGCTG
CCTAGTGAAGCTCATCGGA->CTAGTGAAGCTCATCGGAG
TCACCTCTTCACGCGACTG->CACCTCTTCACGCGACTGA
TAAAAATGTGCCTTGGACT->AAAAATGTGCCTTGGACTA
CAAGATTCCTTATCGAAGC->AAGATTCCTTATCGAAGCT
ATCTTTCCGCATTATGCTC->TCTTTCCGCATTATGCTCA
CTGATTAGAGTCGCGAAAG->TGATTAGAGTCGCGAAAGG
CCGAGTTCGCTATACGCTC->CGAGTTCGCTATACGCTCA
GGTCGGTGGCTATTAAGTC->GTCGGTGGCTATTAAGTCT
ATTACGACATAAGTCCTGC->TTACGACATAAGTCCTGCC
CGCAACTCCCGTAGCTATA->GCAACTCCCGTAGCTATAC
ACTCAGTTCTTCAACTCTT->CTCAGTTCTTCAACTCTTG
ACTTAAGTTAACTCTATAA->CTTAAGTTAACTCTATAAT
GACTCCCAGATCAGTCGCA->ACTCCCAGATCAGTCGCAA
AGGTGTCTGCTTGCACATT->GGTGTCTGCTTGCACATTT
TCTGGGTCCCGTAGCGGAC->CTGGGTCCCGTAGCGGACG
GAAATCATATTCACGCAAA->AAATCATATTCACGCAAAC
GGTAGGCGGGCCAATATAA->GTAGGCGGGCCAATATAAT
CTCTAAGTAATGAAAGCCG->TCTAAGTAATGAAAGCCGA
GTTCCCGACCGTCTGGTAC->TTCCCGACCGTCTGGTACC
TTGCTTCTATGATGCCGTT->TGCTTCTATGATGCCGTTA
GGATTCATACCGAAACATG->GATTCATACCGAAACATGG
TCCGAGGAAGAGGTCATCC->CCGAGGAAGAGGTCATCCC
CTGAGGATACGCAACTCCC->TGAGGATACGCAACTCCCG
GTTCTTCAACTCTTGACCT->TTCTTCAACTCTTGACCTC
GAAAGGGGCCAGTAGTATA->AAAGGGGCCAGTAGTATAC
GCCCTCTGCCGTTTTATTG->CCCTCTGCCGTTTTATTGA
CCGCTCAGTGAACAACCAA->CGCTCAGTGAACAACCAAT
GACCACGCGTCAGCTGTAT->ACCACGCGTCAGCTGTATT
CCAGTAGTATACTGCACCT->CAGTAGTATACTGCACCTA
TTGCTAGCCATCATCAAAA->TGCTAGCCATCATCAAAAG
TCCATCCGTGTGGTCGAAT->CCATCCGTGTGGTCGAATA
CTCGATTCCCGCATCTGCT->TCGATTCCCGCATCTGCTC
GAATTATGTTAGTACGTAG->AATTATGTTAGTACGTAGA
TGATTAGAGTCGCGAAAGG->GATTAGAGTCGCGAAAGGT
ATCCGAGCACAGAGTCGTC->TCCGAGCACAGAGTCGTCC
GTATAGTTATTGAGGAATC->TATAGTTATTGAGGAATCG
CGATACAATAATCTGGACA->GATACAATAATCTGGACAG
ACGCAACTCCCGTAGCTAT->CGCAACTCCCGTAGCTATA
ATCTCGAGGGTAGAATTGT->TCTCGAGGGTAGAATTGTC
GCTTGCACATTTCCTAGTC->CTTGCACATTTCCTAGTCA
TAGGAGCCCTCAGAGGATG->AGGAGCCCTCAGAGGATGA
ATCAAAAGGAGTGTAAAAA->TCAAAAGGAGTGTAAAAAT
CAGTATCTGCCGGAATTTC->AGTATCTGCCGGAATTTCC
CGTAGCTATACCTCCATAT->GTAGCTATACCTCCATATG
GCACAGAGTCGTCCGGGGG->CACAGAGTCGTCCGGGGGC
TAACCTTGACCGCCTCCTG->AACCTTGACCGCCTCCTGC
AAGAAAGGGGCCAGCCTTA->AGAAAGGGGCCAGCCTTAT
GTCGGCTCGAATTATGTTA->TCGGCTCGAATTATGTTAG
CCTGCGAGCCTGCAGGAAG->CTGCGAGCCTGCAGGAAGC
TATACGGGACTCCCAGATC->ATACGGGACTCCCAGATCA
ACGACATAAGTCCTGCCGC->CGACATAAGTCCTGCCGCA
CACATCAATAGTACATGGA->ACATCAATAGTACATGGAT
TCATTGCTCTTTGTGCAGC->CATTGCTCTTTGTGCAGCT
TACATCCTTCCGTTAACGG->ACATCCTTCCGTTAACGGT
AACTACATTGTATTGGCCC->ACTACATTGTATTGGCCCA
AAGTTGTACATATACAACG->AGTTGTACATATACAACGC
CGGGCTACTACGGGAAAGT->GGGCTACTACGGGAAAGTT
AACCAATACCGCCACCCTC->ACCAATACCGCCACCCTCG
CGACGTACGATACAATAAT->GACGTACGATACAATAATC
GTGTGGTGCAAGTACACCA->TGTGGTGCAAGTACACCAC
TCGGTAGTCCCCTCGTTTA->CGGTAGTCCCCTCGTTTAA
TTATCGAAGCTTTGATCTC->TATCGAAGCTTTGATCTCG
AAAAATGTGCCTTGGACTA->AAAATGTGCCTTGGACTAG
CGATTCTCGGCTTTGAGCC->GATTCTCGGCTTTGAGCCC
ATAATTAACACTGGTATAG->TAATTAACACTGGTATAGT
TTTACTTGTGCTTTACATC->TTACTTGTGCTTTACATCC
AAGCTCATCGGAGGCCAGT->AGCTCATCGGAGGCCAGTT
ACCCCAGGCTATAAAAGTA->CCCCAGGCTATAAAAGTAT
GTGCTTTACATCCTTCCGT->TGCTTTACATCCTTCCGTT
ACAAGTTGTACATATACAA->CAAGTTGTACATATACAAC
TGATGCCGTTATAGAGTAC->GATGCCGTTATAGAGTACC
GTGCAGCTTATATGTGTCT->TGCAGCTTATATGTGTCTT
ATCGGAGGCCAGTTGCTAG->TCGGAGGCCAGTTGCTAGC
CCCACATCAATAGTACATG->CCACATCAATAGTACATGG
CCCGTAGCGGACGCATCCG->CCGTAGCGGACGCATCCGA
TCGGTAGGCGGGCCAATAT->CGGTAGGCGGGCCAATATA
CTGGTATAGTTATTGAGGA->TGGTATAGTTATTGAGGAA
CGGAGTATCGGTCATCGAT->GGAGTATCGGTCATCGATA
GCTCTTTGTGCAGCTTATA->CTCTTTGTGCAGCTTATAT
GATTCATACCGAAACATGG->ATTCATACCGAAACATGGT
CTAATTGAACTCAGTTCTT->TAATTGAACTCAGTTCTTC
TTTCCTAGTCACTGCTTGG->TTCCTAGTCACTGCTTGGT
GCAGTTACGCCACTCTCCC->CAGTTACGCCACTCTCCCA
CGCAATCAGAATGTCGGCT->GCAATCAGAATGTCGGCTC
GACGTACGATACAATAATC->ACGTACGATACAATAATCT
CTGCAGGAAGCCAGGTGTC->TGCAGGAAGCCAGGTGTCT
CCACTTAAGTTAACTCTAT->CACTTAAGTTAACTCTATA
ATTTCTTGTTAATTGATTC->TTTCTTGTTAATTGATTCC
GCTCGACCACGCGTCAGCT->CTCGACCACGCGTCAGCTG
ACGGTCCGAGTCATATTCT->CGGTCCGAGTCATATTCTG
ATAGAGTACCAAAGATGGT->TAGAGTACCAAAGATGGTC
TCATTTCTTGTTAATTGAT->CATTTCTTGTTAATTGATT
CGCATCTGCTCATGTCGCC->GCATCTGCTCATGTCGCCA
GTAGACTTCGTATTTGCCG->TAGACTTCGTATTTGCCGG
ACGCCTGAAGGTAAGTCCG->CGCCTGAAGGTAAGTCCGA
GTCCTGCCGCATGAAGCGC->TCCTGCCGCATGAAGCGCA
ATTCACGCAAACCCAAATA->TTCACGCAAACCCAAATAA
TACTCTAAGTAATGAAAGC->ACTCTAAGTAATGAAAGCC
CCTAACCTTGACCGCCTCC->CTAACCTTGACCGCCTCCC,CTAACCTTGACCGCCTCCT
CGAGTGTGGTGCAAGTACA->GAGTGTGGTGCAAGTACAC
CTCAGAGGATGAAAGCCCT->TCAGAGGATGAAAGCCCTC
CCGAGTCATATTCTGCGGG->CGAGTCATATTCTGCGGGG
TCAAGAAAGGGGCCAGCCT->CAAGAAAGGGGCCAGCCTT
ATAGTTATTGAGGAATCGT->TAGTTATTGAGGAATCGTC
CACCCTCGCTCGACCACGC->ACCCTCGCTCGACCACGCG
ACGCAAACCCAAATAATTA->CGCAAACCCAAATAATTAA
GCTATTAAGTCTGTTCGCG->CTATTAAGTCTGTTCGCGC
ATCCACTTAAGTTAACTCT->TCCACTTAAGTTAACTCTA
GCATTATGCTCACCTCTTC->CATTATGCTCACCTCTTCA
TGTCACATATCTGTCGTTA->GTCACATATCTGTCGTTAG
AAGTTCCCTAACAAGGTTT->AGTTCCCTAACAAGGTTTT
GCTGTCATATCAGCTATGT->CTGTCATATCAGCTATGTC
ACACTGGTATAGTTATTGA->CACTGGTATAGTTATTGAG
TAGTCCCTAACTAACCGTT->AGTCCCTAACTAACCGTTA
GTTTCTGGCCTATACGGGA->TTTCTGGCCTATACGGGAC
CTTTCAACCTCGCCAGCGT->TTTCAACCTCGCCAGCGTT
ATGCCGTTATAGAGTACCA->TGCCGTTATAGAGTACCAA
GAGGATGAAAGCCCTCTGC->AGGATGAAAGCCCTCTGCC
TCCCTATTTTCCACCCCAT->CCCTATTTTCCACCCCATC
GACATTAAGGGACAACTAC->ACATTAAGGGACAACTACA
CTACTACGGGAAAGTTCCT->TACTACGGGAAAGTTCCTA
GCTATGTCACATATCTGTC->CTATGTCACATATCTGTCG
AGAAATCCCCTTCCCTATT->GAAATCCCCTTCCCTATTT
ACGCTAGTCCCCCAGTCAG->CGCTAGTCCCCCAGTCAGT
TCTTTCCGCATTATGCTCA->CTTTCCGCATTATGCTCAC
GTGTTTCGCTTATCATTGC->TGTTTCGCTTATCATTGCC
AGTGAACAACCAATACCGC->GTGAACAACCAATACCGCC
AATGACAACCTCTGACCGA->ATGACAACCTCTGACCGAT
GGAAAGTTCCTAGATTCAT->GAAAGTTCCTAGATTCATG
CTATTTTTACTGAGGATAC->TATTTTTACTGAGGATACG
CGCCTCCCGTTTGGCATGG->GCCTCCCGTTTGGCATGGT
ATCCCACATCAATAGTACA->TCCCACATCAATAGTACAT
CTAAGTAATGAAAGCCGAG->TAAGTAATGAAAGCCGAGT
GAAATCCCCTTCCCTATTT->AAATCCCCTTCCCTATTTT
GTCTGTTCGCGCGCTACCA->TCTGTTCGCGCGCTACCAA
ATTGTCTGGGTCCCGTAGC->TTGTCTGGGTCCCGTAGCG
TGACGGTGTGGAATGACAA->GACGGTGTGGAATGACAAC
GCCCTATCACCCCGGAAAG->CCCTATCACCCCGGAAAGA
AGCTGACGCGGATCCACCG->GCTGACGCGGATCCACCGC
CTCTGACCACTAGCGCACA->TCTGACCACTAGCGCACAA
AAGCGCAGTTACGCCACTC->AGCGCAGTTACGCCACTCT
TCACCCCGGAAAGACTCAG->CACCCCGGAAAGACTCAGA
ATACGGGACTCCCAGATCA->TACGGGACTCCCAGATCAG
ACATGGATTCATACCGAAA->CATGGATTCATACCGAAAC
GATAATCTACGCCTGAAGG->ATAATCTACGCCTGAAGGT
ACCGCGGTGCGGCAGTCGT->CCGCGGTGCGGCAGTCGTG
TGAAGCTCATCGGAGGCCA->GAAGCTCATCGGAGGCCAG
CGGATCCACCGCGGTGCGG->GGATCCACCGCGGTGCGGC
GAATGACAACCTCTGACCG->AATGACAACCTCTGACCGA
TCTGCCGGAATTTCCATGT->CTGCCGGAATTTCCATGTT
GTTCCTAGATTCATGCGCT->TTCCTAGATTCATGCGCTA
GGGGCCAGACGCCTCAATA->GGGCCAGACGCCTCAATAA
CTATACGCTCAAGAAAGGG->TATACGCTCAAGAAAGGGG
GAGTCGTCCGGGGGCAAGT->AGTCGTCCGGGGGCAAGTC
ATTTTTACTGAGGATACGC->TTTTTACTGAGGATACGCA
ATTAGAGTCGCGAAAGGTC->TTAGAGTCGCGAAAGGTCG
TGCACATTTCCTAGTCACT->GCACATTTCCTAGTCACTG
TCTAAGTAATGAAAGCCGA->CTAAGTAATGAAAGCCGAG
TCGACCACGCGTCAGCTGT->CGACCACGCGTCAGCTGTA
GTTTTAGTCCCTAACTAAC->TTTTAGTCCCTAACTAACC
GAAAGGTCGGTGGCTATTA->AAAGGTCGGTGGCTATTAA
TCCACCCCATCCGAGGAAG->CCACCCCATCCGAGGAAGA
CTGACGCGGATCCACCGCG->TGACGCGGATCCACCGCGG
GAATCGTCCATCCGTGTGG->AATCGTCCATCCGTGTGGT
CAGTAGTATACTGCACCTA->AGTAGTATACTGCACCTAA
AATTTCCATGTTCATTGCT->ATTTCCATGTTCATTGCTC
TCGATAATCTACGCCTGAA->CGATAATCTACGCCTGAAG
CATTATGCTCACCTCTTCA->ATTATGCTCACCTCTTCAC
ATGCTCACCTCTTCACGCG->TGCTCACCTCTTCACGCGA
CATATCTGTCGTTAGGCTT->ATATCTGTCGTTAGGCTTC
GCCAATATAATGGGCCAAT->CCAATATAATGGGCCAATA
TCTGTCGTTAGGCTTCAGT->CTGTCGTTAGGCTTCAGTA
GTCTGGTACCAACAACGGC->TCTGGTACCAACAACGGCC
CGAATAGACGCTAGTCCCC->GAATAGACGCTAGTCCCCC
GCTTTACATCCTTCCGTTA->CTTTACATCCTTCCGTTAA
GTCCCGGCAACCTAGTGAA->TCCCGGCAACCTAGTGAAG
TACATGGATTCATACCGAA->ACATGGATTCATACCGAAA
GTGTGGAATGACAACCTCT->TGTGGAATGACAACCTCTG
ACATCTCTGTGCTGGTTTC->CATCTCTGTGCTGGTTTCT
TGCTTGCACATTTCCTAGT->GCTTGCACATTTCCTAGTC
TCAGTGAACAACCAATACC->CAGTGAACAACCAATACCG
TCCCCTTCCCTATTTTCCA->CCCCTTCCCTATTTTCCAC
CGAGTTCGCTATACGCTCA->GAGTTCGCTATACGCTCAA
AGGGGCCAGTAGTATACTG->GGGGCCAGTAGTATACTGC
CTTACCTCAACTTTAGGCC->TTACCTCAACTTTAGGCCA
CTATACCTCCATATGCTCA->TATACCTCCATATGCTCAA
GTGAACAACCAATACCGCC->TGAACAACCAATACCGCCA
GAAAAACAAGTTGTACATA->AAAAACAAGTTGTACATAT
AACGGTCCGAGTCATATTC->ACGGTCCGAGTCATATTCT
ACTCTTGACCTCCGCCAAC->CTCTTGACCTCCGCCAACC
CATCAAAAGGAGTGTAAAA->ATCAAAAGGAGTGTAAAAA
TGAAGCGCAGTTACGCCAC->GAAGCGCAGTTACGCCACT
TTCAGTATCTGCCGGAATT->TCAGTATCTGCCGGAATTT
GTCCCCTCGTTTAAACCAC->TCCCCTCGTTTAAACCACA
ACTCAGATTGATATTCCCG->CTCAGATTGATATTCCCGT
TTCCCTATTTTCCACCCCA->TCCCTATTTTCCACCCCAT
AAAGATGGTCGGTAGGCGG->AAGATGGTCGGTAGGCGGG
CCGGTTCTAAATATCCACT->CGGTTCTAAATATCCACTT
TATCGAAGCTTTGATCTCG->ATCGAAGCTTTGATCTCGA
ACCTTGACCGCCTCCCGTT->CCTTGACCGCCTCCCGTTT
CGGGAAAGTTCCTAGATTC->GGGAAAGTTCCTAGATTCA
GCCGTTTTATTGAAGTGGT->CCGTTTTATTGAAGTGGTA
CCGACCGTCTGGTACCAAC->CGACCGTCTGGTACCAACA
CATTAAGGGACAACTACAT->ATTAAGGGACAACTACATT
GTTGTGGCGACGTACGATA->TTGTGGCGACGTACGATAC
ATATCTGTCGTTAGGCTTC->TATCTGTCGTTAGGCTTCA
CCTTGACCGCCTCGCTTGA->CTTGACCGCCTCGCTTGAA
TGCAGCTTATATGTGTCTT->GCAGCTTATATGTGTCTTA
GCGGGGAGTTCTGGTGTCC->CGGGGAGTTCTGGTGTCCC
TCACATCTCTGTGCTGGTT->CACATCTCTGTGCTGGTTT
CTTGACCGCCTCTGACCAC->TTGACCGCCTCTGACCACT
TTATGCTCACCTCTTCACG->TATGCTCACCTCTTCACGC
GCCTCCCGTTTGGCATGGT->CCTCCCGTTTGGCATGGTG
CTAGTGAAGCTCATCGGAG->TAGTGAAGCTCATCGGAGG
TGCACACTAAGTAGCCTAT->GCACACTAAGTAGCCTATT
CGAGGGTAGAATTGTCTGG->GAGGGTAGAATTGTCTGGG
AAACAAGTTGTACATATAC->AACAAGTTGTACATATACA
GCTTGGTGGTCGTCAGCGG->CTTGGTGGTCGTCAGCGGT
GAGTGTAAAAATGTGCCTT->AGTGTAAAAATGTGCCTTG
CATCCGAGCACAGAGTCGT->ATCCGAGCACAGAGTCGTC
TGGGCCAATAGGTTGAGTG->GGGCCAATAGGTTGAGTGA
CACTAGCGCACAAGAAATC->ACTAGCGCACAAGAAATCC
TCAGTCGCAATCAGAATGT->CAGTCGCAATCAGAATGTC
ATACGCAACTCCCGTAGCT->TACGCAACTCCCGTAGCTA
TATGTTAGTACGTAGACTT->ATGTTAGTACGTAGACTTC
CCAGCTGACGCGGATCCAC->CAGCTGACGCGGATCCACC
TAATCTACGCCTGAAGGTA->AATCTACGCCTGAAGGTAA
AGACTCAGATTGATATTCC->GACTCAGATTGATATTCCC
CCCCTCGTTTAAACCACAT->CCCTCGTTTAAACCACATC
GGATGGGTCTCGCTGTCTC->GATGGGTCTCGCTGTCTCG
CCACCCCATCCGAGGAAGA->CACCCCATCCGAGGAAGAG
CACCCCATCCGAGGAAGAG->ACCCCATCCGAGGAAGAGG
CACTTAAGTTAACTCTATA->ACTTAAGTTAACTCTATAA
GGCCAGTAGTATACTGCAC->GCCAGTAGTATACTGCACC
CGGTGCGGCAGTCGTGTCA->GGTGCGGCAGTCGTGTCAT
TCTTGACCTCCGCCAACCA->CTTGACCTCCGCCAACCAC
CCAGACGCCTCAATAACCT->CAGACGCCTCAATAACCTA
GCAGTCGTGTCATGGAATA->CAGTCGTGTCATGGAATAG
AACAAGTTGTACATATACA->ACAAGTTGTACATATACAA
TACGTAGACTTCGTATTTG->ACGTAGACTTCGTATTTGC
GATGCCGTTATAGAGTACC->ATGCCGTTATAGAGTACCA
ACATATGTTGCACTCGGTA->CATATGTTGCACTCGGTAG
GAGTTCGCTATACGCTCAA->AGTTCGCTATACGCTCAAG
TATGTTGCACTCGGTAGTC->ATGTTGCACTCGGTAGTCC
CGACCGTCTGGTACCAACA->GACCGTCTGGTACCAACAA
GTACATATACAACGCCAGC->TACATATACAACGCCAGCT
GTCACATATCTGTCGTTAG->TCACATATCTGTCGTTAGG
AGACGCTAGTCCCCCAGTC->GACGCTAGTCCCCCAGTCA
GTATACTGCACCTAACCTT->TATACTGCACCTAACCTTG
GAACTCAGTTCTTCAACTC->AACTCAGTTCTTCAACTCT
TAAGTAGCCTATTCCAGGT->AAGTAGCCTATTCCAGGTC
TTGAGGAATCGTCCATCCG->TGAGGAATCGTCCATCCGT
TCGCGCCCAGGGTCCTCTC->CGCGCCCAGGGTCCTCTCT
CCATGTTCATTGCTCTTTG->CATGTTCATTGCTCTTTGT
GAAAGCCGAGTGTGGTGCA->AAAGCCGAGTGTGGTGCAA
TATGTCACATATCTGTCGT->ATGTCACATATCTGTCGTT
AAGGATGGGTCTCGCTGTC->AGGATGGGTCTCGCTGTCT
CTTCCCTATTTTCCACCCC->TTCCCTATTTTCCACCCCA
GATTCTCGGCTTTGAGCCC->ATTCTCGGCTTTGAGCCCT
TCTGGCCTATACGGGACTC->CTGGCCTATACGGGACTCC
TAGCGTAACGCGTGTTTCG->AGCGTAACGCGTGTTTCGC
TTTGATCTCGAGGGTAGAA->TTGATCTCGAGGGTAGAAT
GAGGAATCGTCCATCCGTG->AGGAATCGTCCATCCGTGT
AGGCTTCTCGATAATCTAC->GGCTTCTCGATAATCTACG
AGTTCCTAGATTCATGCGC->GTTCCTAGATTCATGCGCT
ATAATCTGGACAGACCCCA->TAATCTGGACAGACCCCAG
CATCTGTTCGCCAATTGGC->ATCTGTTCGCCAATTGGCG
GTCATCGATAAATGCTGTC->TCATCGATAAATGCTGTCA
TGACCGCCTCCTGCGAGCC->GACCGCCTCCTGCGAGCCT
TACCAAAGATGGTCGGTAG->ACCAAAGATGGTCGGTAGG
TCCCGCATCTGCTCATGTC->CCCGCATCTGCTCATGTCG
ACGGCCTTGCTTCTATGAT->CGGCCTTGCTTCTATGATG
GACCCCAGGCTATAAAAGT->ACCCCAGGCTATAAAAGTA
CAGGTCAATCTTTCCGCAT->AGGTCAATCTTTCCGCATT
CTAGTCACTGCTTGGTGGT->TAGTCACTGCTTGGTGGTC
TAGCGGACGCATCCGAGCA->AGCGGACGCATCCGAGCAC
CGGTCGCGCCCAGGGTCCT->GGTCGCGCCCAGGGTCCTC
ATTGGCGGTCGCGCCCAGG->TTGGCGGTCGCGCCCAGGG
CGGAATTTCCATGTTCATT->GGAATTTCCATGTTCATTG
CGTTAACGGTCCGAGTCAT->GTTAACGGTCCGAGTCATA
TCTCGAGGGTAGAATTGTC->CTCGAGGGTAGAATTGTCT
CTCATGTCGCCAGCGACAG->TCATGTCGCCAGCGACAGT
TGCGAGCCTGCAGGAAGCC->GCGAGCCTGCAGGAAGCCA
TTCCGGTTCTAAATATCCA->TCCGGTTCTAAATATCCAC
TCACGCGACTGACATTAAG->CACGCGACTGACATTAAGG
GTCGCAATCAGAATGTCGG->TCGCAATCAGAATGTCGGC
TGATATTCCCGTTACGGAA->GATATTCCCGTTACGGAAG
AAGTAGCCTATTCCAGGTC->AGTAGCCTATTCCAGGTCA
CCGCCACCCTCGCTCGACC->CGCCACCCTCGCTCGACCA
GCCGTTATAGAGTACCAAA->CCGTTATAGAGTACCAAAG
TCTTTGTGCAGCTTATATG->CTTTGTGCAGCTTATATGT
GTAGCTATACCTCCATATG->TAGCTATACCTCCATATGC
TTCAGACTACTCTAAGTAA->TCAGACTACTCTAAGTAAT
CGGAGGCCAGTTGCTAGCC->GGAGGCCAGTTGCTAGCCA
TACGGGACTCCCAGATCAG->ACGGGACTCCCAGATCAGT
GATCTCGAGGGTAGAATTG->ATCTCGAGGGTAGAATTGT
CATATCAGCTATGTCACAT->ATATCAGCTATGTCACATA
CTCAAGAAAGGGGCCAGAC->TCAAGAAAGGGGCCAGACG
CTTGACCGCCTCCCGTTTG->TTGACCGCCTCCCGTTTGG
TGCCGTTATAGAGTACCAA->GCCGTTATAGAGTACCAAA
TACCGCCACCCTCGCTCGA->ACCGCCACCCTCGCTCGAC
AACCTCTGACCGATTCTCG->ACCTCTGACCGATTCTCGG
TACGGGAAAGTTCCTAGAT->ACGGGAAAGTTCCTAGATT
ATAACCTAACCTTGACCGC->TAACCTAACCTTGACCGCC
TTCCCGACCGTCTGGTACC->TCCCGACCGTCTGGTACCA
GGTCGAATAGACGCTAGTC->GTCGAATAGACGCTAGTCC
TGCCGGGTAGTAAATCTAA->GCCGGGTAGTAAATCTAAT
TTGTATTGGCCCATCTAAA->TGTATTGGCCCATCTAAAT
CAAGTCATCGTACATTGCA->AAGTCATCGTACATTGCAC
GTCCATCCGTGTGGTCGAA->TCCATCCGTGTGGTCGAAT
GTTCCGGGCTACTACGGGA->TTCCGGGCTACTACGGGAA
CAAAGAGCGGAGTATCGGT->AAAGAGCGGAGTATCGGTC
CTCCGCTCAGTGAACAACC->TCCGCTCAGTGAACAACCA
TTAAACCACATCTGTTCGC->TAAACCACATCTGTTCGCC
AAGGGGCCAGTAGTATACT->AGGGGCCAGTAGTATACTG
TGCGGGGAGTTCTGGTGTC->GCGGGGAGTTCTGGTGTCC
TATCTGCCGGAATTTCCAT->ATCTGCCGGAATTTCCATG
GGAATCGTCCATCCGTGTG->GAATCGTCCATCCGTGTGG
CTCTATAATCTCCGCTCAG->TCTATAATCTCCGCTCAGT
CTGCTTGCACATTTCCTAG->TGCTTGCACATTTCCTAGT
GTTCATTTCTTGTTAATTG->TTCATTTCTTGTTAATTGA
GTGAAGCTCATCGGAGGCC->TGAAGCTCATCGGAGGCCA
TGAAAGCCGAGTGTGGTGC->GAAAGCCGAGTGTGGTGCA
AAAGCCGAGTGTGGTGCAA->AAGCCGAGTGTGGTGCAAG
CTCGATAATCTACGCCTGA->TCGATAATCTACGCCTGAA
GCTTTGATCTCGAGGGTAG->CTTTGATCTCGAGGGTAGA
ACCAAGCTAGCCCTATCAC->CCAAGCTAGCCCTATCACC
TTTCCACCCCATCCGAGGA->TTCCACCCCATCCGAGGAA
GTCAATCTTTCCGCATTAT->TCAATCTTTCCGCATTATG
AGCGCTAAAAGGCTCAAGA->GCGCTAAAAGGCTCAAGAA
GAGCGGAGTATCGGTCATC->AGCGGAGTATCGGTCATCG
TATACAACGCCAGCTGACG->ATACAACGCCAGCTGACGC
TCTATGATGCCGTTATAGA->CTATGATGCCGTTATAGAG
GTTGAGTGACGGTGTGGAA->TTGAGTGACGGTGTGGAAT
TGGGTCCCGTAGCGGACGC->GGGTCCCGTAGCGGACGCA
TTGGCGGTCGCGCCCAGGG->TGGCGGTCGCGCCCAGGGT
GTGTCCCGGCAACCTAGTG->TGTCCCGGCAACCTAGTGA
GCTAGCCATCATCAAAAGG->CTAGCCATCATCAAAAGGA
AACCTTGACCGCCTCTGAC->ACCTTGACCGCCTCTGACC
CTTCAGTATCTGCCGGAAT->TTCAGTATCTGCCGGAATT
AAGCCAGGTGTCTGCTTGC->AGCCAGGTGTCTGCTTGCA
GCTTGAAGAAATCATATTC->CTTGAAGAAATCATATTCA
GGCAGTAAGCGGACCTAAC->GCAGTAAGCGGACCTAACC
GGGACAACTACATTGTATT->GGACAACTACATTGTATTG
CGTTACGGAAGGATCTGTC->GTTACGGAAGGATCTGTCA
GCCAGCCTTATGCAAGACC->CCAGCCTTATGCAAGACCT
CAATAATCTGGACAGACCC->AATAATCTGGACAGACCCC
TGTTCGCCAATTGGCGGTC->GTTCGCCAATTGGCGGTCG
CCATATGCTCAAGAAAGGG->CATATGCTCAAGAAAGGGG
AGCGCAGTTACGCCACTCT->GCGCAGTTACGCCACTCTC
ACCAAAGATGGTCGGTAGG->CCAAAGATGGTCGGTAGGC
CTCGGCTTTGAGCCCTAGG->TCGGCTTTGAGCCCTAGGG
AGCTGTATTCACCCTCATC->GCTGTATTCACCCTCATCG
ACGCGTCAGCTGTATTCAC->CGCGTCAGCTGTATTCACC
ATATATTATTACGACATAA->TATATTATTACGACATAAG
TAATTTCAGACTACTCTAA->AATTTCAGACTACTCTAAG
AGAGGTCATCCCACATCAA->GAGGTCATCCCACATCAAT
TACCAACAACGGCCTTGCT->ACCAACAACGGCCTTGCTT
CTTGGTGGTCGTCAGCGGT->TTGGTGGTCGTCAGCGGTT
ACTAACCGTTATCTTTCAA->CTAACCGTTATCTTTCAAC
CCGCATTATGCTCACCTCT->CGCATTATGCTCACCTCTT
CCACTCTCCCACTATTTTT->CACTCTCCCACTATTTTTA
CCTCGCTCGACCACGCGTC->CTCGCTCGACCACGCGTCA
GTAGCGGACGCATCCGAGC->TAGCGGACGCATCCGAGCA
CTTATCGAAGCTTTGATCT->TTATCGAAGCTTTGATCTC
GAGTGTGGTGCAAGTACAC->AGTGTGGTGCAAGTACACC
TTCGCGCGCTACCAAGCTA->TCGCGCGCTACCAAGCTAG
CCTTATCGAAGCTTTGATC->CTTATCGAAGCTTTGATCT
TGAGTGACGGTGTGGAATG->GAGTGACGGTGTGGAATGA
CGATAATCTACGCCTGAAG->GATAATCTACGCCTGAAGG
CAGTTTACTTGTGCTTTAC->AGTTTACTTGTGCTTTACA
ACTGACATTAAGGGACAAC->CTGACATTAAGGGACAACT
TATTCCAGGTCAATCTTTC->ATTCCAGGTCAATCTTTCC
TGGCGACGTACGATACAAT->GGCGACGTACGATACAATA
GCTCAAGAAAGGGGCCAGG->CTCAAGAAAGGGGCCAGGC
CGGAAGGATCTGTCACATC->GGAAGGATCTGTCACATCT
AGGCTCAAGAAAGGGGCCA->GGCTCAAGAAAGGGGCCAG
AAGTACACCACCCAGCAAG->AGTACACCACCCAGCAAGT
ACAGTTTACTTGTGCTTTA->CAGTTTACTTGTGCTTTAC
AGAGCGGAGTATCGGTCAT->GAGCGGAGTATCGGTCATC
TCAATCTTTCCGCATTATG->CAATCTTTCCGCATTATGC
ACCAACAACGGCCTTGCTT->CCAACAACGGCCTTGCTTC
ACATTTCCTAGTCACTGCT->CATTTCCTAGTCACTGCTT
TAATGGGCCAATAGGTTGA->AATGGGCCAATAGGTTGAG
CTAGATTCATGCGCTAGCT->TAGATTCATGCGCTAGCTC
TTAATTGATTCCGGTTCTA->TAATTGATTCCGGTTCTAA
TTAACTCTATAATCTCCGC->TAACTCTATAATCTCCGCT
TATGCTCACCTCTTCACGC->ATGCTCACCTCTTCACGCG
GCGGTGCGGCAGTCGTGTC->CGGTGCGGCAGTCGTGTCA
ATGTTAGTACGTAGACTTC->TGTTAGTACGTAGACTTCG
TAATTGAACTCAGTTCTTC->AATTGAACTCAGTTCTTCA
TGTTGCACTCGGTAGTCCC->GTTGCACTCGGTAGTCCCC
CTCACCTCTTCACGCGACT->TCACCTCTTCACGCGACTG
ATATAATGGGCCAATAGGT->TATAATGGGCCAATAGGTT
CTGCGGGGAGTTCTGGTGT->TGCGGGGAGTTCTGGTGTC
CCACTAGCGCACAAGAAAT->CACTAGCGCACAAGAAATC
CAGGCAGTAAGCGGACCTA->AGGCAGTAAGCGGACCTAA
TCATGGAATAGCGTAACGC->CATGGAATAGCGTAACGCG
CCGGGTAGTAAATCTAATT->CGGGTAGTAAATCTAATTG
TGCTTGGTGGTCGTCAGCG->GCTTGGTGGTCGTCAGCGG
CGGTAGTCCCCTCGTTTAA->GGTAGTCCCCTCGTTTAAA
TAGCCATCATCAAAAGGAG->AGCCATCATCAAAAGGAGT
AGTCCGAGTTCGCTATACG->GTCCGAGTTCGCTATACGC
CCTCTGACCACTAGCGCAC->CTCTGACCACTAGCGCACA
TTTGCCGGGTAGTAAATCT->TTGCCGGGTAGTAAATCTA
CCTGCAGGAAGCCAGGTGT->CTGCAGGAAGCCAGGTGTC
TTCGCTATACGCTCAAGAA->TCGCTATACGCTCAAGAAA
ATGTTCATTGCTCTTTGTG->TGTTCATTGCTCTTTGTGC
ACAGAGTCGTCCGGGGGCA->CAGAGTCGTCCGGGGGCAA
AGAGGATGAAAGCCCTCTG->GAGGATGAAAGCCCTCTGC
GATTCCTTATCGAAGCTTT->ATTCCTTATCGAAGCTTTG
GTCACTGCTTGGTGGTCGT->TCACTGCTTGGTGGTCGTC
TGCTCATGTCGCCAGCGAC->GCTCATGTCGCCAGCGACA
TCTTTCAACCTCGCCAGCG->CTTTCAACCTCGCCAGCGT
CGACAGTTTACTTGTGCTT->GACAGTTTACTTGTGCTTT
GGAGTGTAAAAATGTGCCT->GAGTGTAAAAATGTGCCTT
TAAATCTAATTGAACTCAG->AAATCTAATTGAACTCAGT
GGGTCCCGTAGCGGACGCA->GGTCCCGTAGCGGACGCAT
GTACGTAGACTTCGTATTT->TACGTAGACTTCGTATTTG
TAACCTTGACCGCCTCGCT->AACCTTGACCGCCTCGCTT
GTAGTCCCCTCGTTTAAAC->TAGTCCCCTCGTTTAAACC
TAAAAGGATGGGTCTCGCT->AAAAGGATGGGTCTCGCTG
GGATCTGTCACATCTCTGT->GATCTGTCACATCTCTGTG
GTAAGTCCGAGTTCGCTAT->TAAGTCCGAGTTCGCTATA
TCATACCGAAACATGGTTC->CATACCGAAACATGGTTCC
AAGTTGTGGCGACGTACGA->AGTTGTGGCGACGTACGAT
ATAAATGCTGTCATATCAG->TAAATGCTGTCATATCAGC
CGGGGAGTTCTGGTGTCCC->GGGGAGTTCTGGTGTCCCG
TCACTGCTTGGTGGTCGTC->CACTGCTTGGTGGTCGTCA
AATAATTAACACTGGTATA->ATAATTAACACTGGTATAG
TCATCGGAGGCCAGTTGCT->CATCGGAGGCCAGTTGCTA
TTATATGTGTCTTACCTCA->TATATGTGTCTTACCTCAA
AGTGGTAAAAGGATGGGTC->GTGGTAAAAGGATGGGTCT
TACTGAGGATACGCAACTC->ACTGAGGATACGCAACTCC
CCGAGTGTGGTGCAAGTAC->CGAGTGTGGTGCAAGTACA
ATACAATAATCTGGACAGA->TACAATAATCTGGACAGAC
TCCTGCGAGCCTGCAGGAA->CCTGCGAGCCTGCAGGAAG
CGAGCACAGAGTCGTCCGG->GAGCACAGAGTCGTCCGGG
AAGTCATCGTACATTGCAC->AGTCATCGTACATTGCACA
TTCACGCGACTGACATTAA->TCACGCGACTGACATTAAG
ATCTGTTCGCCAATTGGCG->TCTGTTCGCCAATTGGCGG
TTTGAGCCCTAGGGCAAAG->TTGAGCCCTAGGGCAAAGA
TCAACTTTAGGCCAAGATT->CAACTTTAGGCCAAGATTC
TAGAGTACCAAAGATGGTC->AGAGTACCAAAGATGGTCG
TCAATAGTACATGGATTCA->CAATAGTACATGGATTCAT
TATAATGGGCCAATAGGTT->ATAATGGGCCAATAGGTTG
AGGAATCGTCCATCCGTGT->GGAATCGTCCATCCGTGTG
AACCGTTATCTTTCAACCT->ACCGTTATCTTTCAACCTC
CTCGAGGGTAGAATTGTCT->TCGAGGGTAGAATTGTCTG
CACCACCCAGCAAGTTCCC->ACCACCCAGCAAGTTCCCT
CGGGACTCCCAGATCAGTC->GGGACTCCCAGATCAGTCG
CCAATATAATGGGCCAATA->CAATATAATGGGCCAATAG
TAGAATTGTCTGGGTCCCG->AGAATTGTCTGGGTCCCGT
TGACCTCCGCCAACCACAT->GACCTCCGCCAACCACATA
TCCTTATCGAAGCTTTGAT->CCTTATCGAAGCTTTGATC
AGAGTCGCGAAAGGTCGGT->GAGTCGCGAAAGGTCGGTG
CGTTTAAACCACATCTGTT->GTTTAAACCACATCTGTTC
CGGTGGCTATTAAGTCTGT->GGTGGCTATTAAGTCTGTT
GCCTCCTGCGAGCCTGCAG->CCTCCTGCGAGCCTGCAGG
CAATTGGCGGTCGCGCCCA->AATTGGCGGTCGCGCCCAG
TGCCTTGGACTAGCGCTAA->GCCTTGGACTAGCGCTAAA
ATCTGTCACATCTCTGTGC->TCTGTCACATCTCTGTGCT
CGTATTTGCCGGGTAGTAA->GTATTTGCCGGGTAGTAAA
GTTCGCCAATTGGCGGTCG->TTCGCCAATTGGCGGTCGC
AAAATGTGCCTTGGACTAG->AAATGTGCCTTGGACTAGC
AGTTCCCTAACAAGGTTTT->GTTCCCTAACAAGGTTTTA
CCGCCTCTGACCACTAGCG->CGCCTCTGACCACTAGCGC
GCCTCTGACCACTAGCGCA->CCTCTGACCACTAGCGCAC
GTTTAAACCACATCTGTTC->TTTAAACCACATCTGTTCG
AATGTCGGCTCGAATTATG->ATGTCGGCTCGAATTATGT
CGGTAGGCGGGCCAATATA->GGTAGGCGGGCCAATATAA
AGCGGACGCATCCGAGCAC->GCGGACGCATCCGAGCACA
GCTTCTCGATAATCTACGC->CTTCTCGATAATCTACGCC
TGCAAGTACACCACCCAGC->GCAAGTACACCACCCAGCA
AATATAATGGGCCAATAGG->ATATAATGGGCCAATAGGT
GTGGCGACGTACGATACAA->TGGCGACGTACGATACAAT
GGCGGGCCAATATAATGGG->GCGGGCCAATATAATGGGC
GGTGTATATATTATTACGA->GTGTATATATTATTACGAC
GTATTGGCCCATCTAAATC->TATTGGCCCATCTAAATCC
GGTCGTCAGCGGTTCCCGA->GTCGTCAGCGGTTCCCGAC
TAACCGTTATCTTTCAACC->AACCGTTATCTTTCAACCT
GAATTTCCATGTTCATTGC->AATTTCCATGTTCATTGCT
AGCTTTGATCTCGAGGGTA->GCTTTGATCTCGAGGGTAG
GTAAAAGGATGGGTCTCGC->TAAAAGGATGGGTCTCGCT
TACATTGTATTGGCCCATC->ACATTGTATTGGCCCATCT
GATCTGTCACATCTCTGTG->ATCTGTCACATCTCTGTGC
CTCGCTTGAAGAAATCATA->TCGCTTGAAGAAATCATAT
AAGATTCCTTATCGAAGCT->AGATTCCTTATCGAAGCTT
TAACGCGTGTTTCGCTTAT->AACGCGTGTTTCGCTTATC
GTTTTATTGAAGTGGTAAA->TTTTATTGAAGTGGTAAAA
CACGCGACTGACATTAAGG->ACGCGACTGACATTAAGGG
TCTGCGGGGAGTTCTGGTG->CTGCGGGGAGTTCTGGTGT
CATGGAATAGCGTAACGCG->ATGGAATAGCGTAACGCGT
ACGGTGTGGAATGACAACC->CGGTGTGGAATGACAACCT
GCATGAAGCGCAGTTACGC->CATGAAGCGCAGTTACGCC
TCGCCAATTGGCGGTCGCG->CGCCAATTGGCGGTCGCGC
GGCTAATTTCAGACTACTC->GCTAATTTCAGACTACTCT
AATGTGCCTTGGACTAGCG->ATGTGCCTTGGACTAGCGC
CGTGTTTCGCTTATCATTG->GTGTTTCGCTTATCATTGC
GCTAAAAGGCTCAAGAAAG->CTAAAAGGCTCAAGAAAGG
CCAAATAATTAACACTGGT->CAAATAATTAACACTGGTA
GTCGGTAGGCGGGCCAATA->TCGGTAGGCGGGCCAATAT
TCATCGATAAATGCTGTCA->CATCGATAAATGCTGTCAT
CACCTAACCTTGACCGCCT->ACCTAACCTTGACCGCCTC
AAGCTAGCCCTATCACCCC->AGCTAGCCCTATCACCCCG
ATTCACCCTCATCGGGTAG->TTCACCCTCATCGGGTAGG
GACAGTTTACTTGTGCTTT->ACAGTTTACTTGTGCTTTA
TCTCTGTGCTGGTTTCTGG->CTCTGTGCTGGTTTCTGGC
CATAAGTCCTGCCGCATGA->ATAAGTCCTGCCGCATGAA
TATTCCCGTTACGGAAGGA->ATTCCCGTTACGGAAGGAT
ATGTCGGCTCGAATTATGT->TGTCGGCTCGAATTATGTT
CACACTAAGTAGCCTATTC->ACACTAAGTAGCCTATTCC
TAGAGTCGCGAAAGGTCGG->AGAGTCGCGAAAGGTCGGT
AGCTAGCCCTATCACCCCG->GCTAGCCCTATCACCCCGG
AAAGGGGCCAGTAGTATAC->AAGGGGCCAGTAGTATACT
GCGTAACGCGTGTTTCGCT->CGTAACGCGTGTTTCGCTT
GGTGGTCGTCAGCGGTTCC->GTGGTCGTCAGCGGTTCCC
GCCAATAGGTTGAGTGACG->CCAATAGGTTGAGTGACGG
CTGTCGTTAGGCTTCAGTA->TGTCGTTAGGCTTCAGTAT
TATTATTACGACATAAGTC->ATTATTACGACATAAGTCC
CTATACGGGACTCCCAGAT->TATACGGGACTCCCAGATC
GGAGCCCTCAGAGGATGAA->GAGCCCTCAGAGGATGAAA
GCTATACGCTCAAGAAAGG->CTATACGCTCAAGAAAGGG
CATATGCTCAAGAAAGGGG->ATATGCTCAAGAAAGGGGC
CACATCTGTTCGCCAATTG->ACATCTGTTCGCCAATTGG
ACTTGTGCTTTACATCCTT->CTTGTGCTTTACATCCTTC
TACGCAACTCCCGTAGCTA->ACGCAACTCCCGTAGCTAT
TGTGGTCGAATAGACGCTA->GTGGTCGAATAGACGCTAG
TCGTGTCATGGAATAGCGT->CGTGTCATGGAATAGCGTA
GTCTGGGTCCCGTAGCGGA->TCTGGGTCCCGTAGCGGAC
GAGCCCTCAGAGGATGAAA->AGCCCTCAGAGGATGAAAG
ATACGCTCAAGAAAGGGGC->TACGCTCAAGAAAGGGGCC
TGGACTAGCGCTAAAAGGC->GGACTAGCGCTAAAAGGCT
GTCTTACCTCAACTTTAGG->TCTTACCTCAACTTTAGGC
CCACCCTCGCTCGACCACG->CACCCTCGCTCGACCACGC
CTCTCGATTCCCGCATCTG->TCTCGATTCCCGCATCTGC
CGCTTATCATTGCCTAACC->GCTTATCATTGCCTAACCA
CAAGTACACCACCCAGCAA->AAGTACACCACCCAGCAAG
GCAAGACCTAACCTTGACC->CAAGACCTAACCTTGACCG
CAGTTACGCCACTCTCCCA->AGTTACGCCACTCTCCCAC
TTAAGTCTGTTCGCGCGCT->TAAGTCTGTTCGCGCGCTA
AGCGGACCTAACCTTGACC->GCGGACCTAACCTTGACCG
CAATCTTTCCGCATTATGC->AATCTTTCCGCATTATGCT
CTAGCCCTATCACCCCGGA->TAGCCCTATCACCCCGGAA
TCATGTCGCCAGCGACAGT->CATGTCGCCAGCGACAGTT
CACCCCGGAAAGACTCAGA->ACCCCGGAAAGACTCAGAT
CCCCGGAAAGACTCAGATT->CCCGGAAAGACTCAGATTG
CTAAATATCCACTTAAGTT->TAAATATCCACTTAAGTTA
GTTCCCTAACAAGGTTTTA->TTCCCTAACAAGGTTTTAG
AGGCCAGTTGCTAGCCATC->GGCCAGTTGCTAGCCATCA
GCGTTTAAAAAGGCTTCTC->CGTTTAAAAAGGCTTCTCG
ACATGGTTCCGGGCTACTA->CATGGTTCCGGGCTACTAC
CGCTAGCTCAAGAAAGGGG->GCTAGCTCAAGAAAGGGGC
CCATCTAAATCCGGAAAAA->CATCTAAATCCGGAAAAAC
ACCCCATCCGAGGAAGAGG->CCCCATCCGAGGAAGAGGT
TAGTATACTGCACCTAACC->AGTATACTGCACCTAACCT
CAAAGATGGTCGGTAGGCG->AAAGATGGTCGGTAGGCGG
CGGTTCTAAATATCCACTT->GGTTCTAAATATCCACTTA
TGTCGTTAGGCTTCAGTAT->GTCGTTAGGCTTCAGTATC
CCCTCAGAGGATGAAAGCC->CCTCAGAGGATGAAAGCCC
CCTGCCGCATGAAGCGCAG->CTGCCGCATGAAGCGCAGT
GATACAATAATCTGGACAG->ATACAATAATCTGGACAGA
GTAGAATTGTCTGGGTCCC->TAGAATTGTCTGGGTCCCG
ATCTGATTAGAGTCGCGAA->TCTGATTAGAGTCGCGAAA
CAAACCCAAATAATTAACA->AAACCCAAATAATTAACAC
CAGACGCCTCAATAACCTA->AGACGCCTCAATAACCTAA
CCTCATCGGGTAGGAGCCC->CTCATCGGGTAGGAGCCCT
AAGAAATCCCCTTCCCTAT->AGAAATCCCCTTCCCTATT
CGCATCCGAGCACAGAGTC->GCATCCGAGCACAGAGTCG
AGTTTACTTGTGCTTTACA->GTTTACTTGTGCTTTACAT
TAGTACATGGATTCATACC->AGTACATGGATTCATACCG
AAGGCTTCTCGATAATCTA->AGGCTTCTCGATAATCTAC
CTATTCCAGGTCAATCTTT->TATTCCAGGTCAATCTTTC
GTATCTGATTAGAGTCGCG->TATCTGATTAGAGTCGCGA
GGTTCTAAATATCCACTTA->GTTCTAAATATCCACTTAA
CTCTCCCACTATTTTTACT->TCTCCCACTATTTTTACTG
CACATTTCCTAGTCACTGC->ACATTTCCTAGTCACTGCT
TTATCATTGCCTAACCAAG->TATCATTGCCTAACCAAGT
AGTGTGGTGCAAGTACACC->GTGTGGTGCAAGTACACCA
CTGCCGGAATTTCCATGTT->TGCCGGAATTTCCATGTTC
ACATTGTATTGGCCCATCT->CATTGTATTGGCCCATCTA
GCGCTAGCTCAAGAAAGGG->CGCTAGCTCAAGAAAGGGG
AAACCCAAATAATTAACAC->AACCCAAATAATTAACACT
TCCTAGTCACTGCTTGGTG->CCTAGTCACTGCTTGGTGG
TTATCTTTCAACCTCGCCA->TATCTTTCAACCTCGCCAG
AGTCATATTCTGCGGGGAG->GTCATATTCTGCGGGGAGT
GTATTTGCCGGGTAGTAAA->TATTTGCCGGGTAGTAAAT
CAATAGGTTGAGTGACGGT->AATAGGTTGAGTGACGGTG
CCACGCGTCAGCTGTATTC->CACGCGTCAGCTGTATTCA
GTACATGGATTCATACCGA->TACATGGATTCATACCGAA
CAGAATGTCGGCTCGAATT->AGAATGTCGGCTCGAATTA
TTCGCCAATTGGCGGTCGC->TCGCCAATTGGCGGTCGCG
ATACCGCCACCCTCGCTCG->TACCGCCACCCTCGCTCGA
TGTTCATTGCTCTTTGTGC->GTTCATTGCTCTTTGTGCA
TTGACCGCCTCCTGCGAGC->TGACCGCCTCCTGCGAGCC
CCTATTTTCCACCCCATCC->CTATTTTCCACCCCATCCG
ACGATACAATAATCTGGAC->CGATACAATAATCTGGACA
CTAACCTTGACCGCCTCTG->TAACCTTGACCGCCTCTGA
CTCGTTTAAACCACATCTG->TCGTTTAAACCACATCTGT
CTAGCGCTAAAAGGCTCAA->TAGCGCTAAAAGGCTCAAG
GGTAAAAGGATGGGTCTCG->GTAAAAGGATGGGTCTCGC
TGGCTATTAAGTCTGTTCG->GGCTATTAAGTCTGTTCGC
CTGGCCTATACGGGACTCC->TGGCCTATACGGGACTCCC
AGTTAACTCTATAATCTCC->GTTAACTCTATAATCTCCG
GATCCACCGCGGTGCGGCA->ATCCACCGCGGTGCGGCAG
GTTATCTTTCAACCTCGCC->TTATCTTTCAACCTCGCCA
AGCTCAAGAAAGGGGCCAG->GCTCAAGAAAGGGGCCAGA
CCTAACCTTGACCGCCTCG->CTAACCTTGACCGCCTCGC
CTCCCACTATTTTTACTGA->TCCCACTATTTTTACTGAG
TCATATTCACGCAAACCCA->CATATTCACGCAAACCCAA
CACTCTCCCACTATTTTTA->ACTCTCCCACTATTTTTAC
TTCCTAGATTCATGCGCTA->TCCTAGATTCATGCGCTAG
GGATGAAAGCCCTCTGCCG->GATGAAAGCCCTCTGCCGT
ACTCCCGTAGCTATACCTC->CTCCCGTAGCTATACCTCC
GTGTTCATTTCTTGTTAAT->TGTTCATTTCTTGTTAATT
AAAAGTATCTGATTAGAGT->AAAGTATCTGATTAGAGTC
CGCTCGACCACGCGTCAGC->GCTCGACCACGCGTCAGCT
GACCTCCGCCAACCACATA->ACCTCCGCCAACCACATAT
GGCTACTACGGGAAAGTTC->GCTACTACGGGAAAGTTCC
TCCGTGTGGTCGAATAGAC->CCGTGTGGTCGAATAGACG
CAAGAAAGGGGCCAGGCAG->AAGAAAGGGGCCAGGCAGT
TTAGGCTTCAGTATCTGCC->TAGGCTTCAGTATCTGCCG
AAACCACATCTGTTCGCCA->AACCACATCTGTTCGCCAA
GGACCTAACCTTGACCGCC->GACCTAACCTTGACCGCCT
AGAAAGGGGCCAGCCTTAT->GAAAGGGGCCAGCCTTATG
AGGGGCCAGACGCCTCAAT->GGGGCCAGACGCCTCAATA
TTCCGGGCTACTACGGGAA->TCCGGGCTACTACGGGAAA
AACGCGTGTTTCGCTTATC->ACGCGTGTTTCGCTTATCA
GTTCATTGCTCTTTGTGCA->TTCATTGCTCTTTGTGCAG
TAGTCCCCTCGTTTAAACC->AGTCCCCTCGTTTAAACCA
CCAGATCAGTCGCAATCAG->CAGATCAGTCGCAATCAGA
CTGTTCGCGCGCTACCAAG->TGTTCGCGCGCTACCAAGC
GCAGCTTATATGTGTCTTA->CAGCTTATATGTGTCTTAC
TAACCAAGTTGTGGCGACG->AACCAAGTTGTGGCGACGT
CATCATCAAAAGGAGTGTA->ATCATCAAAAGGAGTGTAA
ACTTTAGGCCAAGATTCCT->CTTTAGGCCAAGATTCCTT
TTCTCGATAATCTACGCCT->TCTCGATAATCTACGCCTG
ACTGCTTGGTGGTCGTCAG->CTGCTTGGTGGTCGTCAGC
GGCTTCAGTATCTGCCGGA->GCTTCAGTATCTGCCGGAA
AGCCTTATGCAAGACCTAA->GCCTTATGCAAGACCTAAC
AAGTCCTGCCGCATGAAGC->AGTCCTGCCGCATGAAGCG
GCGCTACCAAGCTAGCCCT->CGCTACCAAGCTAGCCCTA
TATTTTCCACCCCATCCGA->ATTTTCCACCCCATCCGAG
TAAAAGTATCTGATTAGAG->AAAAGTATCTGATTAGAGT
TCCCACTATTTTTACTGAG->CCCACTATTTTTACTGAGG
ACGGAAGGATCTGTCACAT->CGGAAGGATCTGTCACATC
GATACGCAACTCCCGTAGC->ATACGCAACTCCCGTAGCT
CCCTCGCTCGACCACGCGT->CCTCGCTCGACCACGCGTC
GGGGCAAGTCATCGTACAT->GGGCAAGTCATCGTACATT
AATACCGCCACCCTCGCTC->ATACCGCCACCCTCGCTCG
CCCCAGGCTATAAAAGTAT->CCCAGGCTATAAAAGTATC
GTTCGCTATACGCTCAAGA->TTCGCTATACGCTCAAGAA
ATCCGAGGAAGAGGTCATC->TCCGAGGAAGAGGTCATCC
CCTAACTAACCGTTATCTT->CTAACTAACCGTTATCTTT
ATTTCCATGTTCATTGCTC->TTTCCATGTTCATTGCTCT
CTGGTACCAACAACGGCCT->TGGTACCAACAACGGCCTT
AAGGTAAGTCCGAGTTCGC->AGGTAAGTCCGAGTTCGCT
TAAATCCGGAAAAACAAGT->AAATCCGGAAAAACAAGTT
TCTCGATTCCCGCATCTGC->CTCGATTCCCGCATCTGCT
AAATGTGCCTTGGACTAGC->AATGTGCCTTGGACTAGCG
TTCCTTATCGAAGCTTTGA->TCCTTATCGAAGCTTTGAT
CGGCAGTCGTGTCATGGAA->GGCAGTCGTGTCATGGAAT
TAGTCACTGCTTGGTGGTC->AGTCACTGCTTGGTGGTCG
CACTAAGTAGCCTATTCCA->ACTAAGTAGCCTATTCCAG
TAGATTCATGCGCTAGCTC->AGATTCATGCGCTAGCTCA
GGTGTGGAATGACAACCTC->GTGTGGAATGACAACCTCT
CTACGGGAAAGTTCCTAGA->TACGGGAAAGTTCCTAGAT
TCCGCCAACCACATATGTT->CCGCCAACCACATATGTTG
TCGGTGGCTATTAAGTCTG->CGGTGGCTATTAAGTCTGT
GCGCGCTACCAAGCTAGCC->CGCGCTACCAAGCTAGCCC
CGCCAATTGGCGGTCGCGC->GCCAATTGGCGGTCGCGCC
TATCTTTCAACCTCGCCAG->ATCTTTCAACCTCGCCAGC
ATGTCACATATCTGTCGTT->TGTCACATATCTGTCGTTA
TATCACCCCGGAAAGACTC->ATCACCCCGGAAAGACTCA
TAAAAGGCTCAAGAAAGGG->AAAAGGCTCAAGAAAGGGG
CTGTGCTGGTTTCTGGCCT->TGTGCTGGTTTCTGGCCTA
CATGAAGCGCAGTTACGCC->ATGAAGCGCAGTTACGCCA
CTATTTTCCACCCCATCCG->TATTTTCCACCCCATCCGA
CCCGTTACGGAAGGATCTG->CCGTTACGGAAGGATCTGT
GGCAAAGAGCGGAGTATCG->GCAAAGAGCGGAGTATCGG
CTCCATATGCTCAAGAAAG->TCCATATGCTCAAGAAAGG
TGAACAACCAATACCGCCA->GAACAACCAATACCGCCAC
GCGACTGACATTAAGGGAC->CGACTGACATTAAGGGACA
TCCGAGTCATATTCTGCGG->CCGAGTCATATTCTGCGGG
GGATACGCAACTCCCGTAG->GATACGCAACTCCCGTAGC
CCCGGAAAGACTCAGATTG->CCGGAAAGACTCAGATTGA
CTAGCCATCATCAAAAGGA->TAGCCATCATCAAAAGGAG
TGTGCTTTACATCCTTCCG->GTGCTTTACATCCTTCCGT
ATTCCCGCATCTGCTCATG->TTCCCGCATCTGCTCATGT
GGCTTCTCGATAATCTACG->GCTTCTCGATAATCTACGC
TTCCAGGTCAATCTTTCCG->TCCAGGTCAATCTTTCCGC
TACGCCTGAAGGTAAGTCC->ACGCCTGAAGGTAAGTCCG
TACCGAAACATGGTTCCGG->ACCGAAACATGGTTCCGGG
AGTAGCCTATTCCAGGTCA->GTAGCCTATTCCAGGTCAA
CCGTAGCTATACCTCCATA->CGTAGCTATACCTCCATAT
CCAAAGATGGTCGGTAGGC->CAAAGATGGTCGGTAGGCG
AAGAAATCATATTCACGCA->AGAAATCATATTCACGCAA
AGTTCTTCAACTCTTGACC->GTTCTTCAACTCTTGACCT
AGTAAGCGGACCTAACCTT->GTAAGCGGACCTAACCTTG
ACCCTCATCGGGTAGGAGC->CCCTCATCGGGTAGGAGCC
ATGCTGTCATATCAGCTAT->TGCTGTCATATCAGCTATG
TTCCATGTTCATTGCTCTT->TCCATGTTCATTGCTCTTT
TAACAAGGTTTTAGTCCCT->AACAAGGTTTTAGTCCCTA
GGTTCCGGGCTACTACGGG->GTTCCGGGCTACTACGGGA
CTTCCGTTAACGGTCCGAG->TTCCGTTAACGGTCCGAGT
TTCTCGGCTTTGAGCCCTA->TCTCGGCTTTGAGCCCTAG
TTTCAACCTCGCCAGCGTT->TTCAACCTCGCCAGCGTTT
TCGCAATCAGAATGTCGGC->CGCAATCAGAATGTCGGCT
TCCCACATCAATAGTACAT->CCCACATCAATAGTACATG
CCCTAGGGCAAAGAGCGGA->CCTAGGGCAAAGAGCGGAG
CGCCCAGGGTCCTCTCTCG->GCCCAGGGTCCTCTCTCGA
TGATCTCGAGGGTAGAATT->GATCTCGAGGGTAGAATTG
TTGGACTAGCGCTAAAAGG->TGGACTAGCGCTAAAAGGC
CCTCGCTTGAAGAAATCAT->CTCGCTTGAAGAAATCATA
TCAACCTCGCCAGCGTTTA->CAACCTCGCCAGCGTTTAA
GCACTCGGTAGTCCCCTCG->CACTCGGTAGTCCCCTCGT
CGGCTTTGAGCCCTAGGGC->GGCTTTGAGCCCTAGGGCA
ATGATGCCGTTATAGAGTA->TGATGCCGTTATAGAGTAC
TCCGAGCACAGAGTCGTCC->CCGAGCACAGAGTCGTCCG
GTGTCTGCTTGCACATTTC->TGTCTGCTTGCACATTTCC
CTCTTCACGCGACTGACAT->TCTTCACGCGACTGACATT
ATCCGGAAAAACAAGTTGT->TCCGGAAAAACAAGTTGTA
CCAGGTCAATCTTTCCGCA->CAGGTCAATCTTTCCGCAT
ATTGTATTGGCCCATCTAA->TTGTATTGGCCCATCTAAA
CCAAGCTAGCCCTATCACC->CAAGCTAGCCCTATCACCC
GCCTGCAGGAAGCCAGGTG->CCTGCAGGAAGCCAGGTGT
TAGTAAATCTAATTGAACT->AGTAAATCTAATTGAACTC
TCTGCTCATGTCGCCAGCG->CTGCTCATGTCGCCAGCGA
GCACCTAACCTTGACCGCC->CACCTAACCTTGACCGCCT
TTTAGTCCCTAACTAACCG->TTAGTCCCTAACTAACCGT
AACCAAGTTGTGGCGACGT->ACCAAGTTGTGGCGACGTA
CTACCAAGCTAGCCCTATC->TACCAAGCTAGCCCTATCA
TAATGAAAGCCGAGTGTGG->AATGAAAGCCGAGTGTGGT
CCTATTCCAGGTCAATCTT->CTATTCCAGGTCAATCTTT
GCTCAAGAAAGGGGCCAGC->CTCAAGAAAGGGGCCAGCC
AGGATGGGTCTCGCTGTCT->GGATGGGTCTCGCTGTCTC
AATATCCACTTAAGTTAAC->ATATCCACTTAAGTTAACT
TCGCCAGCGACAGTTTACT->CGCCAGCGACAGTTTACTT
TGTAAAAATGTGCCTTGGA->GTAAAAATGTGCCTTGGAC
AGGTAAGTCCGAGTTCGCT->GGTAAGTCCGAGTTCGCTA
AATTATGTTAGTACGTAGA->ATTATGTTAGTACGTAGAC
CACATCTCTGTGCTGGTTT->ACATCTCTGTGCTGGTTTC
AGGCAGTAAGCGGACCTAA->GGCAGTAAGCGGACCTAAC
GTTCTAAATATCCACTTAA->TTCTAAATATCCACTTAAG
CAGATTGATATTCCCGTTA->AGATTGATATTCCCGTTAC
TATACCTCCATATGCTCAA->ATACCTCCATATGCTCAAG
TAACCTTGACCGCCTCTGA->AACCTTGACCGCCTCTGAC
AAAGGGGCCAGCCTTATGC->AAGGGGCCAGCCTTATGCA
AGAAAGGGGCCAGGCAGTA->GAAAGGGGCCAGGCAGTAA
GGTGTCCCGGCAACCTAGT->GTGTCCCGGCAACCTAGTG
CTATAATCTCCGCTCAGTG->TATAATCTCCGCTCAGTGA
GGTAAGTCCGAGTTCGCTA->GTAAGTCCGAGTTCGCTAT
CTATAAAAGTATCTGATTA->TATAAAAGTATCTGATTAG
TAGACTTCGTATTTGCCGG->AGACTTCGTATTTGCCGGG
TGGTCGAATAGACGCTAGT->GGTCGAATAGACGCTAGTC
GGGCAAAGAGCGGAGTATC->GGCAAAGAGCGGAGTATCG
CTTCAACTCTTGACCTCCG->TTCAACTCTTGACCTCCGC
TCCGCTCAGTGAACAACCA->CCGCTCAGTGAACAACCAA
GAGGAAGAGGTCATCCCAC->AGGAAGAGGTCATCCCACA
AGCTCATCGGAGGCCAGTT->GCTCATCGGAGGCCAGTTG
GAGTCGCGAAAGGTCGGTG->AGTCGCGAAAGGTCGGTGG
AATCAGAATGTCGGCTCGA->ATCAGAATGTCGGCTCGAA
CTTTCCGCATTATGCTCAC->TTTCCGCATTATGCTCACC
CAACCTAGTGAAGCTCATC->AACCTAGTGAAGCTCATCG
ATCCCCTTCCCTATTTTCC->TCCCCTTCCCTATTTTCCA
CAGTGTTCATTTCTTGTTA->AGTGTTCATTTCTTGTTAA
CACTGGTATAGTTATTGAG->ACTGGTATAGTTATTGAGG
CTCGAATTATGTTAGTACG->TCGAATTATGTTAGTACGT
TCTTCAACTCTTGACCTCC->CTTCAACTCTTGACCTCCG
AGTATCTGATTAGAGTCGC->GTATCTGATTAGAGTCGCG
AAGAGGTCATCCCACATCA->AGAGGTCATCCCACATCAA
TCGTCAGCGGTTCCCGACC->CGTCAGCGGTTCCCGACCG
TGGTACCAACAACGGCCTT->GGTACCAACAACGGCCTTG
AATTTCAGACTACTCTAAG->ATTTCAGACTACTCTAAGT
CCGTTATCTTTCAACCTCG->CGTTATCTTTCAACCTCGC
ACCTCTTCACGCGACTGAC->CCTCTTCACGCGACTGACA
TCTGGACAGACCCCAGGCT->CTGGACAGACCCCAGGCTA
CCAGGGTCCTCTCTCGATT->CAGGGTCCTCTCTCGATTC
CTTGCTTCTATGATGCCGT->TTGCTTCTATGATGCCGTT
AAGTCTGTTCGCGCGCTAC->AGTCTGTTCGCGCGCTACC
CAAAAGGAGTGTAAAAATG->AAAAGGAGTGTAAAAATGT
TCTCGATAATCTACGCCTG->CTCGATAATCTACGCCTGA
CGTTTGGCATGGTGTATAT->GTTTGGCATGGTGTATATA
ATCCACCGCGGTGCGGCAG->TCCACCGCGGTGCGGCAGT
TGGTCGGTAGGCGGGCCAA->GGTCGGTAGGCGGGCCAAT
GTATCGGTCATCGATAAAT->TATCGGTCATCGATAAATG
GCCAGTAGTATACTGCACC->CCAGTAGTATACTGCACCT
TGGCGGTCGCGCCCAGGGT->GGCGGTCGCGCCCAGGGTC
ATACAACGCCAGCTGACGC->TACAACGCCAGCTGACGCG
ACTCTCCCACTATTTTTAC->CTCTCCCACTATTTTTACT
TTACTTGTGCTTTACATCC->TACTTGTGCTTTACATCCT
GTTCTGGTGTCCCGGCAAC->TTCTGGTGTCCCGGCAACC
TAAGTCCTGCCGCATGAAG->AAGTCCTGCCGCATGAAGC
TGTATATATTATTACGACA->GTATATATTATTACGACAT
AGAAATCATATTCACGCAA->GAAATCATATTCACGCAAA
TTAGTCCCTAACTAACCGT->TAGTCCCTAACTAACCGTT
TAGCTATACCTCCATATGC->AGCTATACCTCCATATGCT
TTCACGCAAACCCAAATAA->TCACGCAAACCCAAATAAT
GTGACGGTGTGGAATGACA->TGACGGTGTGGAATGACAA
GTTTGGCATGGTGTATATA->TTTGGCATGGTGTATATAT
CGCGGTGCGGCAGTCGTGT->GCGGTGCGGCAGTCGTGTC
TAACCTTGACCGCCTCCCG->AACCTTGACCGCCTCCCGT
TCTGACCACTAGCGCACAA->CTGACCACTAGCGCACAAG
TAGGGCAAAGAGCGGAGTA->AGGGCAAAGAGCGGAGTAT
TCAAGAAAGGGGCCAGGCA->CAAGAAAGGGGCCAGGCAG
TCCATGTTCATTGCTCTTT->CCATGTTCATTGCTCTTTG
AAAGGTCGGTGGCTATTAA->AAGGTCGGTGGCTATTAAG
CTTGCACATTTCCTAGTCA->TTGCACATTTCCTAGTCAC
GGCAAGTCATCGTACATTG->GCAAGTCATCGTACATTGC
CAAGACCTAACCTTGACCG->AAGACCTAACCTTGACCGC
TTCAACCTCGCCAGCGTTT->TCAACCTCGCCAGCGTTTA
CAAGGTTTTAGTCCCTAAC->AAGGTTTTAGTCCCTAACT
CGTAGCGGACGCATCCGAG->GTAGCGGACGCATCCGAGC
GAAGAGGTCATCCCACATC->AAGAGGTCATCCCACATCA
GAAGCCAGGTGTCTGCTTG->AAGCCAGGTGTCTGCTTGC
CTTAAGTTAACTCTATAAT->TTAAGTTAACTCTATAATC
CCAGGCTATAAAAGTATCT->CAGGCTATAAAAGTATCTG
TTAAGGGACAACTACATTG->TAAGGGACAACTACATTGT
TCCGGGGGCAAGTCATCGT->CCGGGGGCAAGTCATCGTA
TAAGGGACAACTACATTGT->AAGGGACAACTACATTGTA
TCGTATTTGCCGGGTAGTA->CGTATTTGCCGGGTAGTAA
TCCGTTAACGGTCCGAGTC->CCGTTAACGGTCCGAGTCA
TCAACTCTTGACCTCCGCC->CAACTCTTGACCTCCGCCA
AGTCCCTAACTAACCGTTA->GTCCCTAACTAACCGTTAT
TAGCGCTAAAAGGCTCAAG->AGCGCTAAAAGGCTCAAGA
CGCCTCAATAACCTAACCT->GCCTCAATAACCTAACCTT
TGTCGGCTCGAATTATGTT->GTCGGCTCGAATTATGTTA
CTCCCAGATCAGTCGCAAT->TCCCAGATCAGTCGCAATC
AGTGTAAAAATGTGCCTTG->GTGTAAAAATGTGCCTTGG
CCCCCAGTCAGTGTTCATT->CCCCAGTCAGTGTTCATTT
GCAAAGAGCGGAGTATCGG->CAAAGAGCGGAGTATCGGT
CCCAGCAAGTTCCCTAACA->CCAGCAAGTTCCCTAACAA
GGGCCAGACGCCTCAATAA->GGCCAGACGCCTCAATAAC
CAAGAAAGGGGCCAGCCTT->AAGAAAGGGGCCAGCCTTA
ATTGAAGTGGTAAAAGGAT->TTGAAGTGGTAAAAGGATG
GGACTCCCAGATCAGTCGC->GACTCCCAGATCAGTCGCA
TTATGTTAGTACGTAGACT->TATGTTAGTACGTAGACTT
TTATAGAGTACCAAAGATG->TATAGAGTACCAAAGATGG
CTATGTCACATATCTGTCG->TATGTCACATATCTGTCGT
AGGCTATAAAAGTATCTGA->GGCTATAAAAGTATCTGAT
TTGTGGCGACGTACGATAC->TGTGGCGACGTACGATACA
TCTGCTTGCACATTTCCTA->CTGCTTGCACATTTCCTAG
TTTCGCTTATCATTGCCTA->TTCGCTTATCATTGCCTAA
CAAATAATTAACACTGGTA->AAATAATTAACACTGGTAT
GATTCCCGCATCTGCTCAT->ATTCCCGCATCTGCTCATG
CAAGAAAGGGGCCAGTAGT->AAGAAAGGGGCCAGTAGTA
CATGGATTCATACCGAAAC->ATGGATTCATACCGAAACA
AAAAGGCTCAAGAAAGGGG->AAAGGCTCAAGAAAGGGGC
ATCTAAATCCGGAAAAACA->TCTAAATCCGGAAAAACAA
GTTAACGGTCCGAGTCATA->TTAACGGTCCGAGTCATAT
CGTGTGGTCGAATAGACGC->GTGTGGTCGAATAGACGCT
TCGCCAGCGTTTAAAAAGG->CGCCAGCGTTTAAAAAGGC
TCCCTAACTAACCGTTATC->CCCTAACTAACCGTTATCT
TCTACGCCTGAAGGTAAGT->CTACGCCTGAAGGTAAGTC
TCAATAACCTAACCTTGAC->CAATAACCTAACCTTGACC
GTCGCCAGCGACAGTTTAC->TCGCCAGCGACAGTTTACT
TCAGACTACTCTAAGTAAT->CAGACTACTCTAAGTAATG
CGCTTGAAGAAATCATATT->GCTTGAAGAAATCATATTC
TTCCCTAACAAGGTTTTAG->TCCCTAACAAGGTTTTAGT
CATCAATAGTACATGGATT->ATCAATAGTACATGGATTC
CGGACGCATCCGAGCACAG->GGACGCATCCGAGCACAGA
CATCTGCTCATGTCGCCAG->ATCTGCTCATGTCGCCAGC
CATCCCACATCAATAGTAC->ATCCCACATCAATAGTACA
CCTGAAGGTAAGTCCGAGT->CTGAAGGTAAGTCCGAGTT
AAAAACAAGTTGTACATAT->AAAACAAGTTGTACATATA
GCCAGCGACAGTTTACTTG->CCAGCGACAGTTTACTTGT
CAACAACGGCCTTGCTTCT->AACAACGGCCTTGCTTCTA
CGTAGACTTCGTATTTGCC->GTAGACTTCGTATTTGCCG
AATCCCCTTCCCTATTTTC->ATCCCCTTCCCTATTTTCC
AATAGACGCTAGTCCCCCA->ATAGACGCTAGTCCCCCAG
TCCACCGCGGTGCGGCAGT->CCACCGCGGTGCGGCAGTC
TTACATCCTTCCGTTAACG->TACATCCTTCCGTTAACGG
ACCCAGCAAGTTCCCTAAC->CCCAGCAAGTTCCCTAACA
GCGTCAGCTGTATTCACCC->CGTCAGCTGTATTCACCCT
CAGTCGCAATCAGAATGTC->AGTCGCAATCAGAATGTCG
CAATACCGCCACCCTCGCT->AATACCGCCACCCTCGCTC
GGGACTCCCAGATCAGTCG->GGACTCCCAGATCAGTCGC
CACGCAAACCCAAATAATT->ACGCAAACCCAAATAATTA
ATTCCAGGTCAATCTTTCC->TTCCAGGTCAATCTTTCCG
AGGGACAACTACATTGTAT->GGGACAACTACATTGTATT
CTAACTAACCGTTATCTTT->TAACTAACCGTTATCTTTC
CCAGGCAGTAAGCGGACCT->CAGGCAGTAAGCGGACCTA
AAGAAAGGGGCCAGACGCC->AGAAAGGGGCCAGACGCCT
CCTCTGCCGTTTTATTGAA->CTCTGCCGTTTTATTGAAG
CCGTGTGGTCGAATAGACG->CGTGTGGTCGAATAGACGC
TGCTCAAGAAAGGGGCCAG->GCTCAAGAAAGGGGCCAGT
TCTCCCACTATTTTTACTG->CTCCCACTATTTTTACTGA
TGTGCTGGTTTCTGGCCTA->GTGCTGGTTTCTGGCCTAT
CAGTTCTTCAACTCTTGAC->AGTTCTTCAACTCTTGACC
TTATTACGACATAAGTCCT->TATTACGACATAAGTCCTG
CATATACAACGCCAGCTGA->ATATACAACGCCAGCTGAC
TGACATTAAGGGACAACTA->GACATTAAGGGACAACTAC
AGGAAGAGGTCATCCCACA->GGAAGAGGTCATCCCACAT
AAACATGGTTCCGGGCTAC->AACATGGTTCCGGGCTACT
ACCACATCTGTTCGCCAAT->CCACATCTGTTCGCCAATT
GCCACTCTCCCACTATTTT->CCACTCTCCCACTATTTTT
TAGGCTTCAGTATCTGCCG->AGGCTTCAGTATCTGCCGG
ATTAAGTCTGTTCGCGCGC->TTAAGTCTGTTCGCGCGCT
AATCCGGAAAAACAAGTTG->ATCCGGAAAAACAAGTTGT
TGGTGCAAGTACACCACCC->GGTGCAAGTACACCACCCA
AGACGCCTCAATAACCTAA->GACGCCTCAATAACCTAAC
ATTCTGCGGGGAGTTCTGG->TTCTGCGGGGAGTTCTGGT
GTAGGCGGGCCAATATAAT->TAGGCGGGCCAATATAATG
CCGGGGGCAAGTCATCGTA->CGGGGGCAAGTCATCGTAC
AATTGGCGGTCGCGCCCAG->ATTGGCGGTCGCGCCCAGG
TCAGTATCTGCCGGAATTT->CAGTATCTGCCGGAATTTC
TCCGCATTATGCTCACCTC->CCGCATTATGCTCACCTCT
AAAGACTCAGATTGATATT->AAGACTCAGATTGATATTC
AGCGCACAAGAAATCCCCT->GCGCACAAGAAATCCCCTT
GTCCGAGTTCGCTATACGC->TCCGAGTTCGCTATACGCT
CAGCTGTATTCACCCTCAT->AGCTGTATTCACCCTCATC
CCTCCATATGCTCAAGAAA->CTCCATATGCTCAAGAAAG
CATCCGAGGAAGAGGTCAT->ATCCGAGGAAGAGGTCATC
CTCGCTCGACCACGCGTCA->TCGCTCGACCACGCGTCAG
CGCGGATCCACCGCGGTGC->GCGGATCCACCGCGGTGCG
CGAATTATGTTAGTACGTA->GAATTATGTTAGTACGTAG
CAGCTATGTCACATATCTG->AGCTATGTCACATATCTGT
AGGTTGAGTGACGGTGTGG->GGTTGAGTGACGGTGTGGA
ATGTTGCACTCGGTAGTCC->TGTTGCACTCGGTAGTCCC
AGATTCCTTATCGAAGCTT->GATTCCTTATCGAAGCTTT
CATCGTACATTGCACACTA->ATCGTACATTGCACACTAA
ATGCAAGACCTAACCTTGA->TGCAAGACCTAACCTTGAC
AAAGCCCTCTGCCGTTTTA->AAGCCCTCTGCCGTTTTAT
GGTAGGAGCCCTCAGAGGA->GTAGGAGCCCTCAGAGGAT
GTGCAAGTACACCACCCAG->TGCAAGTACACCACCCAGC
GGTACCAACAACGGCCTTG->GTACCAACAACGGCCTTGC
CGTCTGGTACCAACAACGG->GTCTGGTACCAACAACGGC
GGCCTATACGGGACTCCCA->GCCTATACGGGACTCCCAG
TACGACATAAGTCCTGCCG->ACGACATAAGTCCTGCCGC
CAGGCTATAAAAGTATCTG->AGGCTATAAAAGTATCTGA
ATGGAATAGCGTAACGCGT->TGGAATAGCGTAACGCGTG
GGGCCAATATAATGGGCCA->GGCCAATATAATGGGCCAA
AGTCGCGAAAGGTCGGTGG->GTCGCGAAAGGTCGGTGGC
ACAACCAATACCGCCACCC->CAACCAATACCGCCACCCT
ACCTTGACCGCCTCCTGCG->CCTTGACCGCCTCCTGCGA
CTCTGTGCTGGTTTCTGGC->TCTGTGCTGGTTTCTGGCC
GCGGAGTATCGGTCATCGA->CGGAGTATCGGTCATCGAT
GTTAATTGATTCCGGTTCT->TTAATTGATTCCGGTTCTA
GGTTTCTGGCCTATACGGG->GTTTCTGGCCTATACGGGA
TAAAAAGGCTTCTCGATAA->AAAAAGGCTTCTCGATAAT
GGCCCATCTAAATCCGGAA->GCCCATCTAAATCCGGAAA
AGCAAGTTCCCTAACAAGG->GCAAGTTCCCTAACAAGGT
TCTGACCGATTCTCGGCTT->CTGACCGATTCTCGGCTTT
AATTGTCTGGGTCCCGTAG->ATTGTCTGGGTCCCGTAGC
AACCTTGACCGCCTCCCGT->ACCTTGACCGCCTCCCGTT
TTAAAAAGGCTTCTCGATA->TAAAAAGGCTTCTCGATAA
AGTACCAAAGATGGTCGGT->GTACCAAAGATGGTCGGTA
AAGGGGCCAGACGCCTCAA->AGGGGCCAGACGCCTCAAT
CTAACCTTGACCGCCTCGC->TAACCTTGACCGCCTCGCT
TCCCGTAGCGGACGCATCC->CCCGTAGCGGACGCATCCG
CTGACATTAAGGGACAACT->TGACATTAAGGGACAACTA
CAGGAAGCCAGGTGTCTGC->AGGAAGCCAGGTGTCTGCT
ACCGCCTCCTGCGAGCCTG->CCGCCTCCTGCGAGCCTGC
GTCGCGCCCAGGGTCCTCT->TCGCGCCCAGGGTCCTCTC
AGGGTAGAATTGTCTGGGT->GGGTAGAATTGTCTGGGTC
GCCTTGCTTCTATGATGCC->CCTTGCTTCTATGATGCCG
CCTCGTTTAAACCACATCT->CTCGTTTAAACCACATCTG
AGACCCCAGGCTATAAAAG->GACCCCAGGCTATAAAAGT
ACTCTATAATCTCCGCTCA->CTCTATAATCTCCGCTCAG
GGTTCCCGACCGTCTGGTA->GTTCCCGACCGTCTGGTAC
GGTGCGGCAGTCGTGTCAT->GTGCGGCAGTCGTGTCATG
CCTTCCCTATTTTCCACCC->CTTCCCTATTTTCCACCCC
GGGCCAGGCAGTAAGCGGA->GGCCAGGCAGTAAGCGGAC
CGCTAAAAGGCTCAAGAAA->GCTAAAAGGCTCAAGAAAG
TGGATTCATACCGAAACAT->GGATTCATACCGAAACATG
GTTACGGAAGGATCTGTCA->TTACGGAAGGATCTGTCAC
TACGCTCAAGAAAGGGGCC->ACGCTCAAGAAAGGGGCCA
GGCCAGGCAGTAAGCGGAC->GCCAGGCAGTAAGCGGACC
ATGGTGTATATATTATTAC->TGGTGTATATATTATTACG
AGTATCGGTCATCGATAAA->GTATCGGTCATCGATAAAT
AATAATCTGGACAGACCCC->ATAATCTGGACAGACCCCA
CGTCCGGGGGCAAGTCATC->GTCCGGGGGCAAGTCATCG
ATGTGCCTTGGACTAGCGC->TGTGCCTTGGACTAGCGCT
ATAAGTCCTGCCGCATGAA->TAAGTCCTGCCGCATGAAG
ACCTCTGACCGATTCTCGG->CCTCTGACCGATTCTCGGC
TGTCTGGGTCCCGTAGCGG->GTCTGGGTCCCGTAGCGGA
GGAGGCCAGTTGCTAGCCA->GAGGCCAGTTGCTAGCCAT
TCGTCCGGGGGCAAGTCAT->CGTCCGGGGGCAAGTCATC
GAAGTGGTAAAAGGATGGG->AAGTGGTAAAAGGATGGGT
CTCTGACCGATTCTCGGCT->TCTGACCGATTCTCGGCTT
CAAGAAAGGGGCCAGACGC->AAGAAAGGGGCCAGACGCC
GAAGCTCATCGGAGGCCAG->AAGCTCATCGGAGGCCAGT
CTCGGTAGTCCCCTCGTTT->TCGGTAGTCCCCTCGTTTA
CGTCAGCGGTTCCCGACCG->GTCAGCGGTTCCCGACCGT
GTCATCCCACATCAATAGT->TCATCCCACATCAATAGTA
ATAGTACATGGATTCATAC->TAGTACATGGATTCATACC
AAGCTTTGATCTCGAGGGT->AGCTTTGATCTCGAGGGTA
AGGCCAAGATTCCTTATCG->GGCCAAGATTCCTTATCGA
CTCATCGGAGGCCAGTTGC->TCATCGGAGGCCAGTTGCT
AACATGGTTCCGGGCTACT->ACATGGTTCCGGGCTACTA
GGCTCGAATTATGTTAGTA->GCTCGAATTATGTTAGTAC
GAATTGTCTGGGTCCCGTA->AATTGTCTGGGTCCCGTAG
GTACCAAAGATGGTCGGTA->TACCAAAGATGGTCGGTAG
CCTCAGAGGATGAAAGCCC->CTCAGAGGATGAAAGCCCT
GCTCACCTCTTCACGCGAC->CTCACCTCTTCACGCGACT
TCCCAGATCAGTCGCAATC->CCCAGATCAGTCGCAATCA
GAAGGATCTGTCACATCTC->AAGGATCTGTCACATCTCT
CTCAGTTCTTCAACTCTTG->TCAGTTCTTCAACTCTTGA
TATATGTGTCTTACCTCAA->ATATGTGTCTTACCTCAAC
AAAGGGGCCAGGCAGTAAG->AAGGGGCCAGGCAGTAAGC
CCCCAGTCAGTGTTCATTT->CCCAGTCAGTGTTCATTTC
TTCCGCATTATGCTCACCT->TCCGCATTATGCTCACCTC
CTGAAGGTAAGTCCGAGTT->TGAAGGTAAGTCCGAGTTC
TCATGCGCTAGCTCAAGAA->CATGCGCTAGCTCAAGAAA
TTATTGAGGAATCGTCCAT->TATTGAGGAATCGTCCATC
TTCTGGCCTATACGGGACT->TCTGGCCTATACGGGACTC
GACGCGGATCCACCGCGGT->ACGCGGATCCACCGCGGTG
GGTTTTAGTCCCTAACTAA->GTTTTAGTCCCTAACTAAC
TGTGGAATGACAACCTCTG->GTGGAATGACAACCTCTGA
CCGTTATAGAGTACCAAAG->CGTTATAGAGTACCAAAGA
GTAAAAATGTGCCTTGGAC->TAAAAATGTGCCTTGGACT
TCAAAAGGAGTGTAAAAAT->CAAAAGGAGTGTAAAAATG
TATAGTTATTGAGGAATCG->ATAGTTATTGAGGAATCGT
CATCTCTGTGCTGGTTTCT->ATCTCTGTGCTGGTTTCTG
AGATTGATATTCCCGTTAC->GATTGATATTCCCGTTACG
CCCCATCCGAGGAAGAGGT->CCCATCCGAGGAAGAGGTC
CTTGGACTAGCGCTAAAAG->TTGGACTAGCGCTAAAAGG
ATGAAGCGCAGTTACGCCA->TGAAGCGCAGTTACGCCAC
CCGAAACATGGTTCCGGGC->CGAAACATGGTTCCGGGCT
CCACTATTTTTACTGAGGA->CACTATTTTTACTGAGGAT
GCCTCGCTTGAAGAAATCA->CCTCGCTTGAAGAAATCAT
CATCGATAAATGCTGTCAT->ATCGATAAATGCTGTCATA
TGACCGCCTCTGACCACTA->GACCGCCTCTGACCACTAG
CCCTAACAAGGTTTTAGTC->CCTAACAAGGTTTTAGTCC
GGTCCGAGTCATATTCTGC->GTCCGAGTCATATTCTGCG
TCGTTTAAACCACATCTGT->CGTTTAAACCACATCTGTT
AGTTACGCCACTCTCCCAC->GTTACGCCACTCTCCCACT
ATGCTCAAGAAAGGGGCCA->TGCTCAAGAAAGGGGCCAG
CGCTCAAGAAAGGGGCCAG->GCTCAAGAAAGGGGCCAGC
GGTTGAGTGACGGTGTGGA->GTTGAGTGACGGTGTGGAA
TGCTCTTTGTGCAGCTTAT->GCTCTTTGTGCAGCTTATA
GGGAGTTCTGGTGTCCCGG->GGAGTTCTGGTGTCCCGGC
CAAGCTAGCCCTATCACCC->AAGCTAGCCCTATCACCCC
TAAGTCCGAGTTCGCTATA->AAGTCCGAGTTCGCTATAC
GGCCAGACGCCTCAATAAC->GCCAGACGCCTCAATAACC
CCCTATCACCCCGGAAAGA->CCTATCACCCCGGAAAGAC
CGTTTAAAAAGGCTTCTCG->GTTTAAAAAGGCTTCTCGA
TCCGGTTCTAAATATCCAC->CCGGTTCTAAATATCCACT
ACCTCCATATGCTCAAGAA->CCTCCATATGCTCAAGAAA
GTCAGCTGTATTCACCCTC->TCAGCTGTATTCACCCTCA
TCTATAATCTCCGCTCAGT->CTATAATCTCCGCTCAGTG
ACCACTAGCGCACAAGAAA->CCACTAGCGCACAAGAAAT
GGCCAATATAATGGGCCAA->GCCAATATAATGGGCCAAT
TCAGATTGATATTCCCGTT->CAGATTGATATTCCCGTTA
CAGGGTCCTCTCTCGATTC->AGGGTCCTCTCTCGATTCC
TGTGTCTTACCTCAACTTT->GTGTCTTACCTCAACTTTA
AACTCCCGTAGCTATACCT->ACTCCCGTAGCTATACCTC
ACCGAAACATGGTTCCGGG->CCGAAACATGGTTCCGGGC
GTGCTGGTTTCTGGCCTAT->TGCTGGTTTCTGGCCTATA
GTTACGCCACTCTCCCACT->TTACGCCACTCTCCCACTA
ATCTTTCAACCTCGCCAGC->TCTTTCAACCTCGCCAGCG
TACGGAAGGATCTGTCACA->ACGGAAGGATCTGTCACAT
GGGTAGGAGCCCTCAGAGG->GGTAGGAGCCCTCAGAGGA
CAACGCCAGCTGACGCGGA->AACGCCAGCTGACGCGGAT
AAGAAAGGGGCCAGTAGTA->AGAAAGGGGCCAGTAGTAT
CGCTCAGTGAACAACCAAT->GCTCAGTGAACAACCAATA
AGTCCTGCCGCATGAAGCG->GTCCTGCCGCATGAAGCGC
TGCGGCAGTCGTGTCATGG->GCGGCAGTCGTGTCATGGA
CGGGGGCAAGTCATCGTAC->GGGGGCAAGTCATCGTACA
CCATCATCAAAAGGAGTGT->CATCATCAAAAGGAGTGTA
AAAGGAGTGTAAAAATGTG->AAGGAGTGTAAAAATGTGC
ACTGGTATAGTTATTGAGG->CTGGTATAGTTATTGAGGA
GGGTAGAATTGTCTGGGTC->GGTAGAATTGTCTGGGTCC
ACCGCCTCCCGTTTGGCAT->CCGCCTCCCGTTTGGCATG
CCTCCGCCAACCACATATG->CTCCGCCAACCACATATGT
ACCGCCTCGCTTGAAGAAA->CCGCCTCGCTTGAAGAAAT
TCAAGAAAGGGGCCAGTAG->CAAGAAAGGGGCCAGTAGT
GGTCGCGCCCAGGGTCCTC->GTCGCGCCCAGGGTCCTCT
AGCGTTTAAAAAGGCTTCT->GCGTTTAAAAAGGCTTCTC
CCTTATGCAAGACCTAACC->CTTATGCAAGACCTAACCT
GTGCGGCAGTCGTGTCATG->TGCGGCAGTCGTGTCATGG
GTAGTATACTGCACCTAAC->TAGTATACTGCACCTAACC
TTGTCTGGGTCCCGTAGCG->TGTCTGGGTCCCGTAGCGG
CGCTACCAAGCTAGCCCTA->GCTACCAAGCTAGCCCTAT
ATCTAATTGAACTCAGTTC->TCTAATTGAACTCAGTTCT
TCCCTAACAAGGTTTTAGT->CCCTAACAAGGTTTTAGTC
GCTTATATGTGTCTTACCT->CTTATATGTGTCTTACCTC
CTAACCGTTATCTTTCAAC->TAACCGTTATCTTTCAACC
TAGGTTGAGTGACGGTGTG->AGGTTGAGTGACGGTGTGG
CACGCGTCAGCTGTATTCA->ACGCGTCAGCTGTATTCAC
ATCAATAGTACATGGATTC->TCAATAGTACATGGATTCA
CGTTTTATTGAAGTGGTAA->GTTTTATTGAAGTGGTAAA
ATATACAACGCCAGCTGAC->TATACAACGCCAGCTGACG
GCCCTCAGAGGATGAAAGC->CCCTCAGAGGATGAAAGCC
GAGTCATATTCTGCGGGGA->AGTCATATTCTGCGGGGAG
CATTGCCTAACCAAGTTGT->ATTGCCTAACCAAGTTGTG
ACCACGCGTCAGCTGTATT->CCACGCGTCAGCTGTATTC
AAGCGGACCTAACCTTGAC->AGCGGACCTAACCTTGACC
AATCTCCGCTCAGTGAACA->ATCTCCGCTCAGTGAACAA
CTAAATCCGGAAAAACAAG->TAAATCCGGAAAAACAAGT
GTCATGGAATAGCGTAACG->TCATGGAATAGCGTAACGC
AGAAAGGGGCCAGACGCCT->GAAAGGGGCCAGACGCCTC
TATATTATTACGACATAAG->ATATTATTACGACATAAGT
CCCAGTCAGTGTTCATTTC->CCAGTCAGTGTTCATTTCT
CATCCGTGTGGTCGAATAG->ATCCGTGTGGTCGAATAGA
ACCGTTATCTTTCAACCTC->CCGTTATCTTTCAACCTCG
TTGCCGGGTAGTAAATCTA->TGCCGGGTAGTAAATCTAA
GGGGGCAAGTCATCGTACA->GGGGCAAGTCATCGTACAT
TGTCGCCAGCGACAGTTTA->GTCGCCAGCGACAGTTTAC
AGTCGTGTCATGGAATAGC->GTCGTGTCATGGAATAGCG
ACCCTCGCTCGACCACGCG->CCCTCGCTCGACCACGCGT
GACGCATCCGAGCACAGAG->ACGCATCCGAGCACAGAGT
CACAAGAAATCCCCTTCCC->ACAAGAAATCCCCTTCCCT
GCAAGTCATCGTACATTGC->CAAGTCATCGTACATTGCA
CCGCGGTGCGGCAGTCGTG->CGCGGTGCGGCAGTCGTGT
TATCAGCTATGTCACATAT->ATCAGCTATGTCACATATC
GAAAGTTCCTAGATTCATG->AAAGTTCCTAGATTCATGC
TAGCCTATTCCAGGTCAAT->AGCCTATTCCAGGTCAATC
ACCACATATGTTGCACTCG->CCACATATGTTGCACTCGG
AAAAAGGCTTCTCGATAAT->AAAAGGCTTCTCGATAATC
CAATCAGAATGTCGGCTCG->AATCAGAATGTCGGCTCGA
TATGCTCAAGAAAGGGGCC->ATGCTCAAGAAAGGGGCCA
GTTTCGCTTATCATTGCCT->TTTCGCTTATCATTGCCTA
AAATCATATTCACGCAAAC->AATCATATTCACGCAAACC
ATATTCCCGTTACGGAAGG->TATTCCCGTTACGGAAGGA
TGCAAGACCTAACCTTGAC->GCAAGACCTAACCTTGACC
GCCATCATCAAAAGGAGTG->CCATCATCAAAAGGAGTGT
CAACCTCTGACCGATTCTC->AACCTCTGACCGATTCTCG
TATTCACGCAAACCCAAAT->ATTCACGCAAACCCAAATA
TTCTGGTGTCCCGGCAACC->TCTGGTGTCCCGGCAACCT
ACAACTACATTGTATTGGC->CAACTACATTGTATTGGCC
TTGTGCAGCTTATATGTGT->TGTGCAGCTTATATGTGTC
TTCTATGATGCCGTTATAG->TCTATGATGCCGTTATAGA
CGGTCCGAGTCATATTCTG->GGTCCGAGTCATATTCTGC
ACCGCCACCCTCGCTCGAC->CCGCCACCCTCGCTCGACC
GATATTCCCGTTACGGAAG->ATATTCCCGTTACGGAAGG
TTCACCCTCATCGGGTAGG->TCACCCTCATCGGGTAGGA
CAAGAAATCCCCTTCCCTA->AAGAAATCCCCTTCCCTAT
AATGCTGTCATATCAGCTA->ATGCTGTCATATCAGCTAT
CGCAGTTACGCCACTCTCC->GCAGTTACGCCACTCTCCC
CATCCTTCCGTTAACGGTC->ATCCTTCCGTTAACGGTCC
AGCCCTCAGAGGATGAAAG->GCCCTCAGAGGATGAAAGC
TTTGGCATGGTGTATATAT->TTGGCATGGTGTATATATT
ATTGATTCCGGTTCTAAAT->TTGATTCCGGTTCTAAATA
CGTACATTGCACACTAAGT->GTACATTGCACACTAAGTA
CGACCACGCGTCAGCTGTA->GACCACGCGTCAGCTGTAT
ATATTATTACGACATAAGT->TATTATTACGACATAAGTC
CGCCTCGCTTGAAGAAATC->GCCTCGCTTGAAGAAATCA
CGTACGATACAATAATCTG->GTACGATACAATAATCTGG
AACCCAAATAATTAACACT->ACCCAAATAATTAACACTG
TCCCGGCAACCTAGTGAAG->CCCGGCAACCTAGTGAAGC
GCCAGCTGACGCGGATCCA->CCAGCTGACGCGGATCCAC
CATATTCTGCGGGGAGTTC->ATATTCTGCGGGGAGTTCT
TATCTGTCGTTAGGCTTCA->ATCTGTCGTTAGGCTTCAG
CGCATGAAGCGCAGTTACG->GCATGAAGCGCAGTTACGC
AACTCTTGACCTCCGCCAA->ACTCTTGACCTCCGCCAAC
CACATATGTTGCACTCGGT->ACATATGTTGCACTCGGTA
TGACCGATTCTCGGCTTTG->GACCGATTCTCGGCTTTGA
GTACCAACAACGGCCTTGC->TACCAACAACGGCCTTGCT
TGACCGCCTCCCGTTTGGC->GACCGCCTCCCGTTTGGCA
GTCACATCTCTGTGCTGGT->TCACATCTCTGTGCTGGTT
GTGGAATGACAACCTCTGA->TGGAATGACAACCTCTGAC
GTAGCCTATTCCAGGTCAA->TAGCCTATTCCAGGTCAAT
GTCGTGTCATGGAATAGCG->TCGTGTCATGGAATAGCGT
CCTTGACCGCCTCCTGCGA->CTTGACCGCCTCCTGCGAG
TCGAATTATGTTAGTACGT->CGAATTATGTTAGTACGTA
TCAGCTGTATTCACCCTCA->CAGCTGTATTCACCCTCAT
CGCCAGCGTTTAAAAAGGC->GCCAGCGTTTAAAAAGGCT
TACTTGTGCTTTACATCCT->ACTTGTGCTTTACATCCTT
GGACGCATCCGAGCACAGA->GACGCATCCGAGCACAGAG
TCCGAGTTCGCTATACGCT->CCGAGTTCGCTATACGCTC
GCAACCTAGTGAAGCTCAT->CAACCTAGTGAAGCTCATC
TATAATCTCCGCTCAGTGA->ATAATCTCCGCTCAGTGAA
ACGCGTGTTTCGCTTATCA->CGCGTGTTTCGCTTATCAT
CAGAGGATGAAAGCCCTCT->AGAGGATGAAAGCCCTCTG
GCTACTACGGGAAAGTTCC->CTACTACGGGAAAGTTCCT
GCACAAGAAATCCCCTTCC->CACAAGAAATCCCCTTCCC
AGACTACTCTAAGTAATGA->GACTACTCTAAGTAATGAA
GCGGTTCCCGACCGTCTGG->CGGTTCCCGACCGTCTGGT
ACCTCGCCAGCGTTTAAAA->CCTCGCCAGCGTTTAAAAA
CCCGTAGCTATACCTCCAT->CCGTAGCTATACCTCCATA
CGCGTGTTTCGCTTATCAT->GCGTGTTTCGCTTATCATT
GCCAACCACATATGTTGCA->CCAACCACATATGTTGCAC
GCCACCCTCGCTCGACCAC->CCACCCTCGCTCGACCACG
TAATCTGGACAGACCCCAG->AATCTGGACAGACCCCAGG
CTAACCTTGACCGCCTCCT->TAACCTTGACCGCCTCCTG
TGCCGGAATTTCCATGTTC->GCCGGAATTTCCATGTTCA
TTACTGAGGATACGCAACT->TACTGAGGATACGCAACTC
AGGGCAAAGAGCGGAGTAT->GGGCAAAGAGCGGAGTATC
TTTGTGCAGCTTATATGTG->TTGTGCAGCTTATATGTGT
ACTACATTGTATTGGCCCA->CTACATTGTATTGGCCCAT
CATCGGGTAGGAGCCCTCA->ATCGGGTAGGAGCCCTCAG
AGTCCCCTCGTTTAAACCA->GTCCCCTCGTTTAAACCAC
TGTCTGCTTGCACATTTCC->GTCTGCTTGCACATTTCCT
AACTAACCGTTATCTTTCA->ACTAACCGTTATCTTTCAA
CGCCACCCTCGCTCGACCA->GCCACCCTCGCTCGACCAC
TATTGGCCCATCTAAATCC->ATTGGCCCATCTAAATCCG
GCCAATTGGCGGTCGCGCC->CCAATTGGCGGTCGCGCCC
TCGCTTATCATTGCCTAAC->CGCTTATCATTGCCTAACC
CCAGTTGCTAGCCATCATC->CAGTTGCTAGCCATCATCA
TACATTGCACACTAAGTAG->ACATTGCACACTAAGTAGC
CCACCCAGCAAGTTCCCTA->CACCCAGCAAGTTCCCTAA
CGAAAGGTCGGTGGCTATT->GAAAGGTCGGTGGCTATTA
CCGCATGAAGCGCAGTTAC->CGCATGAAGCGCAGTTACG
CAGTTGCTAGCCATCATCA->AGTTGCTAGCCATCATCAA
CTAGTCCCCCAGTCAGTGT->TAGTCCCCCAGTCAGTGTT
GCTCGAATTATGTTAGTAC->CTCGAATTATGTTAGTACG
ACATCTGTTCGCCAATTGG->CATCTGTTCGCCAATTGGC
GGGGAGTTCTGGTGTCCCG->GGGAGTTCTGGTGTCCCGG
ACTATTTTTACTGAGGATA->CTATTTTTACTGAGGATAC
GGAATGACAACCTCTGACC->GAATGACAACCTCTGACCG
CCGTTACGGAAGGATCTGT->CGTTACGGAAGGATCTGTC
CCCATCTAAATCCGGAAAA->CCATCTAAATCCGGAAAAA
CTGCGAGCCTGCAGGAAGC->TGCGAGCCTGCAGGAAGCC
GTTATTGAGGAATCGTCCA->TTATTGAGGAATCGTCCAT
CCGTTTGGCATGGTGTATA->CGTTTGGCATGGTGTATAT
GCTAGTCCCCCAGTCAGTG->CTAGTCCCCCAGTCAGTGT
TGGCCCATCTAAATCCGGA->GGCCCATCTAAATCCGGAA
GGCTATTAAGTCTGTTCGC->GCTATTAAGTCTGTTCGCG
AAATCTAATTGAACTCAGT->AATCTAATTGAACTCAGTT
GCTACCAAGCTAGCCCTAT->CTACCAAGCTAGCCCTATC
TATTAAGTCTGTTCGCGCG->ATTAAGTCTGTTCGCGCGC
GCGCTAAAAGGCTCAAGAA->CGCTAAAAGGCTCAAGAAA
TCGATTCCCGCATCTGCTC->CGATTCCCGCATCTGCTCA
AGGATCTGTCACATCTCTG->GGATCTGTCACATCTCTGT
TATATATTATTACGACATA->ATATATTATTACGACATAA
TCTAAATCCGGAAAAACAA->CTAAATCCGGAAAAACAAG
ACCTCAACTTTAGGCCAAG->CCTCAACTTTAGGCCAAGA
TCCCCCAGTCAGTGTTCAT->CCCCCAGTCAGTGTTCATT
CTTTACATCCTTCCGTTAA->TTTACATCCTTCCGTTAAC
CATGGTTCCGGGCTACTAC->ATGGTTCCGGGCTACTACG
TGGTGTATATATTATTACG->GGTGTATATATTATTACGA
TACACCACCCAGCAAGTTC->ACACCACCCAGCAAGTTCC
AGCTATGTCACATATCTGT->GCTATGTCACATATCTGTC
AGTCCCCCAGTCAGTGTTC->GTCCCCCAGTCAGTGTTCA
GTCCGAGTCATATTCTGCG->TCCGAGTCATATTCTGCGG
ACTACTCTAAGTAATGAAA->CTACTCTAAGTAATGAAAG
TATTACGACATAAGTCCTG->ATTACGACATAAGTCCTGC
CACATATCTGTCGTTAGGC->ACATATCTGTCGTTAGGCT
CTCTTTGTGCAGCTTATAT->TCTTTGTGCAGCTTATATG
CCGGAAAAACAAGTTGTAC->CGGAAAAACAAGTTGTACA
ACTCTAAGTAATGAAAGCC->CTCTAAGTAATGAAAGCCG
GGGCAAGTCATCGTACATT->GGCAAGTCATCGTACATTG
AATAGTACATGGATTCATA->ATAGTACATGGATTCATAC
TCACGCAAACCCAAATAAT->CACGCAAACCCAAATAATT
CGAAGCTTTGATCTCGAGG->GAAGCTTTGATCTCGAGGG
TGACAACCTCTGACCGATT->GACAACCTCTGACCGATTC
CTATTAAGTCTGTTCGCGC->TATTAAGTCTGTTCGCGCG
AACCTTGACCGCCTCCTGC->ACCTTGACCGCCTCCTGCG
TCTTGTTAATTGATTCCGG->CTTGTTAATTGATTCCGGT
GTGTCTTACCTCAACTTTA->TGTCTTACCTCAACTTTAG
ATTAACACTGGTATAGTTA->TTAACACTGGTATAGTTAT
AAATCCCCTTCCCTATTTT->AATCCCCTTCCCTATTTTC
AGGTTTTAGTCCCTAACTA->GGTTTTAGTCCCTAACTAA
AACCTAACCTTGACCGCCT->ACCTAACCTTGACCGCCTC
AGGCTTCAGTATCTGCCGG->GGCTTCAGTATCTGCCGGA
AGATCAGTCGCAATCAGAA->GATCAGTCGCAATCAGAAT
CTTATCATTGCCTAACCAA->TTATCATTGCCTAACCAAG
TAGTTATTGAGGAATCGTC->AGTTATTGAGGAATCGTCC
GACCGCCTCCTGCGAGCCT->ACCGCCTCCTGCGAGCCTG
TTGAAGAAATCATATTCAC->TGAAGAAATCATATTCACG
ATCATCAAAAGGAGTGTAA->TCATCAAAAGGAGTGTAAA
ACATCCTTCCGTTAACGGT->CATCCTTCCGTTAACGGTC
ATCAGCTATGTCACATATC->TCAGCTATGTCACATATCT
ATGGATTCATACCGAAACA->TGGATTCATACCGAAACAT
CATTTCCTAGTCACTGCTT->ATTTCCTAGTCACTGCTTG
TAGTCCCCCAGTCAGTGTT->AGTCCCCCAGTCAGTGTTC
TACCTCCATATGCTCAAGA->ACCTCCATATGCTCAAGAA
GTTCGCGCGCTACCAAGCT->TTCGCGCGCTACCAAGCTA
ACAAGGTTTTAGTCCCTAA->CAAGGTTTTAGTCCCTAAC
AAGGGGCCAGCCTTATGCA->AGGGGCCAGCCTTATGCAA
GATTGATATTCCCGTTACG->ATTGATATTCCCGTTACGG
AAATATCCACTTAAGTTAA->AATATCCACTTAAGTTAAC
TAGTGAAGCTCATCGGAGG->AGTGAAGCTCATCGGAGGC
TAGTACGTAGACTTCGTAT->AGTACGTAGACTTCGTATT
TCTCCGCTCAGTGAACAAC->CTCCGCTCAGTGAACAACC
GTGGTGCAAGTACACCACC->TGGTGCAAGTACACCACCC
TAAACCACATCTGTTCGCC->AAACCACATCTGTTCGCCA
ACAGACCCCAGGCTATAAA->CAGACCCCAGGCTATAAAA
TGGAATAGCGTAACGCGTG->GGAATAGCGTAACGCGTGT
TTGCACATTTCCTAGTCAC->TGCACATTTCCTAGTCACT
GGGTCCTCTCTCGATTCCC->GGTCCTCTCTCGATTCCCG
GTTGCACTCGGTAGTCCCC->TTGCACTCGGTAGTCCCCT
CTTCACGCGACTGACATTA->TTCACGCGACTGACATTAA
TCCTAGATTCATGCGCTAG->CCTAGATTCATGCGCTAGC
AAGTCCGAGTTCGCTATAC->AGTCCGAGTTCGCTATACG
CTTGACCTCCGCCAACCAC->TTGACCTCCGCCAACCACA
TCGTACATTGCACACTAAG->CGTACATTGCACACTAAGT
AACCACATCTGTTCGCCAA->ACCACATCTGTTCGCCAAT
GCTGTATTCACCCTCATCG->CTGTATTCACCCTCATCGG
CCAGCGACAGTTTACTTGT->CAGCGACAGTTTACTTGTG
TCTTCACGCGACTGACATT->CTTCACGCGACTGACATTA
AACAACCAATACCGCCACC->ACAACCAATACCGCCACCC
ATCCTTCCGTTAACGGTCC->TCCTTCCGTTAACGGTCCG
CGGGTAGTAAATCTAATTG->GGGTAGTAAATCTAATTGA
GCTGACGCGGATCCACCGC->CTGACGCGGATCCACCGCG
AGGCGGGCCAATATAATGG->GGCGGGCCAATATAATGGG
AGTACATGGATTCATACCG->GTACATGGATTCATACCGA
GGCCAAGATTCCTTATCGA->GCCAAGATTCCTTATCGAA
CGCAAACCCAAATAATTAA->GCAAACCCAAATAATTAAC
GAGTACCAAAGATGGTCGG->AGTACCAAAGATGGTCGGT
GGCGGTCGCGCCCAGGGTC->GCGGTCGCGCCCAGGGTCC
CCTCAACTTTAGGCCAAGA->CTCAACTTTAGGCCAAGAT
AAAGTATCTGATTAGAGTC->AAGTATCTGATTAGAGTCG
AGTCAGTGTTCATTTCTTG->GTCAGTGTTCATTTCTTGT
CGCCTCTGACCACTAGCGC->GCCTCTGACCACTAGCGCA
CTCAATAACCTAACCTTGA->TCAATAACCTAACCTTGAC
GAGTTCTGGTGTCCCGGCA->AGTTCTGGTGTCCCGGCAA
GCCTATACGGGACTCCCAG->CCTATACGGGACTCCCAGA
ATCGGTCATCGATAAATGC->TCGGTCATCGATAAATGCT
AGCGTAACGCGTGTTTCGC->GCGTAACGCGTGTTTCGCT
AAGTTAACTCTATAATCTC->AGTTAACTCTATAATCTCC
ACTTCGTATTTGCCGGGTA->CTTCGTATTTGCCGGGTAG
ACGCCTCAATAACCTAACC->CGCCTCAATAACCTAACCT
CATACCGAAACATGGTTCC->ATACCGAAACATGGTTCCG
ACAAGAAATCCCCTTCCCT->CAAGAAATCCCCTTCCCTA
TTTCTTGTTAATTGATTCC->TTCTTGTTAATTGATTCCG
CCGGGCTACTACGGGAAAG->CGGGCTACTACGGGAAAGT
ATTGCTCTTTGTGCAGCTT->TTGCTCTTTGTGCAGCTTA
ACGCCAGCTGACGCGGATC->CGCCAGCTGACGCGGATCC
GGGGCCAGTAGTATACTGC->GGGCCAGTAGTATACTGCA
GTCAGCGGTTCCCGACCGT->TCAGCGGTTCCCGACCGTC
CCCAAATAATTAACACTGG->CCAAATAATTAACACTGGT
CAACCTCGCCAGCGTTTAA->AACCTCGCCAGCGTTTAAA
CTCAAGAAAGGGGCCAGTA->TCAAGAAAGGGGCCAGTAG
ATGTGTCTTACCTCAACTT->TGTGTCTTACCTCAACTTT
GTCGCGAAAGGTCGGTGGC->TCGCGAAAGGTCGGTGGCT
CAGTAAGCGGACCTAACCT->AGTAAGCGGACCTAACCTT
TAAGTCTGTTCGCGCGCTA->AAGTCTGTTCGCGCGCTAC
CCACATATGTTGCACTCGG->CACATATGTTGCACTCGGT
CCAAGATTCCTTATCGAAG->CAAGATTCCTTATCGAAGC
GAGGATACGCAACTCCCGT->AGGATACGCAACTCCCGTA
GCCAAGATTCCTTATCGAA->CCAAGATTCCTTATCGAAG
ATATGCTCAAGAAAGGGGC->TATGCTCAAGAAAGGGGCC
CGCATTATGCTCACCTCTT->GCATTATGCTCACCTCTTC
AGGTCAATCTTTCCGCATT->GGTCAATCTTTCCGCATTA
CCTAACCAAGTTGTGGCGA->CTAACCAAGTTGTGGCGAC
GCCTCAATAACCTAACCTT->CCTCAATAACCTAACCTTG
TGCACCTAACCTTGACCGC->GCACCTAACCTTGACCGCC
TTGGCATGGTGTATATATT->TGGCATGGTGTATATATTA
GGTAGTCCCCTCGTTTAAA->GTAGTCCCCTCGTTTAAAC
CTCAGTGAACAACCAATAC->TCAGTGAACAACCAATACC
CTCAGATTGATATTCCCGT->TCAGATTGATATTCCCGTT
CAGTCGTGTCATGGAATAG->AGTCGTGTCATGGAATAGC
TCATCGGGTAGGAGCCCTC->CATCGGGTAGGAGCCCTCA
AAAAGGCTTCTCGATAATC->AAAGGCTTCTCGATAATCT
ATTGAGGAATCGTCCATCC->TTGAGGAATCGTCCATCCG
GCGGTCGCGCCCAGGGTCC->CGGTCGCGCCCAGGGTCCT
TCGATAAATGCTGTCATAT->CGATAAATGCTGTCATATC
CTAACCAAGTTGTGGCGAC->TAACCAAGTTGTGGCGACG
CAACTTTAGGCCAAGATTC->AACTTTAGGCCAAGATTCC
AAGGGACAACTACATTGTA->AGGGACAACTACATTGTAT
AAGCCGAGTGTGGTGCAAG->AGCCGAGTGTGGTGCAAGT
GGTATAGTTATTGAGGAAT->GTATAGTTATTGAGGAATC
CTCATCGGGTAGGAGCCCT->TCATCGGGTAGGAGCCCTC
TGGTTTCTGGCCTATACGG->GGTTTCTGGCCTATACGGG
ATCGATAAATGCTGTCATA->TCGATAAATGCTGTCATAT
CCTTGACCGCCTCCCGTTT->CTTGACCGCCTCCCGTTTG
TTTACTGAGGATACGCAAC->TTACTGAGGATACGCAACT
TATCCACTTAAGTTAACTC->ATCCACTTAAGTTAACTCT
ACACTAAGTAGCCTATTCC->CACTAAGTAGCCTATTCCA
ATGGTCGGTAGGCGGGCCA->TGGTCGGTAGGCGGGCCAA
ATCCGTGTGGTCGAATAGA->TCCGTGTGGTCGAATAGAC
GCTGGTTTCTGGCCTATAC->CTGGTTTCTGGCCTATACG
TTTCAGACTACTCTAAGTA->TTCAGACTACTCTAAGTAA
TTGTGCTTTACATCCTTCC->TGTGCTTTACATCCTTCCG
CCAATTGGCGGTCGCGCCC->CAATTGGCGGTCGCGCCCA
AGTTGCTAGCCATCATCAA->GTTGCTAGCCATCATCAAA
CCCTATTTTCCACCCCATC->CCTATTTTCCACCCCATCC
ACGCCACTCTCCCACTATT->CGCCACTCTCCCACTATTT
GTACGATACAATAATCTGG->TACGATACAATAATCTGGA
TCCTGCCGCATGAAGCGCA->CCTGCCGCATGAAGCGCAG
CGTGTCATGGAATAGCGTA->GTGTCATGGAATAGCGTAA
ATGGGCCAATAGGTTGAGT->TGGGCCAATAGGTTGAGTG
AATCTACGCCTGAAGGTAA->ATCTACGCCTGAAGGTAAG
CTGACCACTAGCGCACAAG->TGACCACTAGCGCACAAGA
CCCACTATTTTTACTGAGG->CCACTATTTTTACTGAGGA
CCAACCACATATGTTGCAC->CAACCACATATGTTGCACT
AGAAAGGGGCCAGTAGTAT->GAAAGGGGCCAGTAGTATA
CCCGTTTGGCATGGTGTAT->CCGTTTGGCATGGTGTATA
GAAAGACTCAGATTGATAT->AAAGACTCAGATTGATATT
ACAACGCCAGCTGACGCGG->CAACGCCAGCTGACGCGGA
ATATGTGTCTTACCTCAAC->TATGTGTCTTACCTCAACT
AGCCTGCAGGAAGCCAGGT->GCCTGCAGGAAGCCAGGTG
TCCAGGTCAATCTTTCCGC->CCAGGTCAATCTTTCCGCA
TCAGCTATGTCACATATCT->CAGCTATGTCACATATCTG
AATCATATTCACGCAAACC->ATCATATTCACGCAAACCC
GCGGACGCATCCGAGCACA->CGGACGCATCCGAGCACAG
GCCTATTCCAGGTCAATCT->CCTATTCCAGGTCAATCTT
GAAAGCCCTCTGCCGTTTT->AAAGCCCTCTGCCGTTTTA
CAGCCTTATGCAAGACCTA->AGCCTTATGCAAGACCTAA
TATTTTTACTGAGGATACG->ATTTTTACTGAGGATACGC
TCGGAGGCCAGTTGCTAGC->CGGAGGCCAGTTGCTAGCC
AGCCCTCTGCCGTTTTATT->GCCCTCTGCCGTTTTATTG
CACTATTTTTACTGAGGAT->ACTATTTTTACTGAGGATA
GCGGGCCAATATAATGGGC->CGGGCCAATATAATGGGCC
AGAATTGTCTGGGTCCCGT->GAATTGTCTGGGTCCCGTA
TGGCATGGTGTATATATTA->GGCATGGTGTATATATTAT
TGTATTGGCCCATCTAAAT->GTATTGGCCCATCTAAATC
CGTCAGCTGTATTCACCCT->GTCAGCTGTATTCACCCTC
GAAGGTAAGTCCGAGTTCG->AAGGTAAGTCCGAGTTCGC
TCTGTTCGCCAATTGGCGG->CTGTTCGCCAATTGGCGGT
GAAACATGGTTCCGGGCTA->AAACATGGTTCCGGGCTAC
AGCACAGAGTCGTCCGGGG->GCACAGAGTCGTCCGGGGG
ACCCCGGAAAGACTCAGAT->CCCCGGAAAGACTCAGATT
GAGGTCATCCCACATCAAT->AGGTCATCCCACATCAATA
CAGCGTTTAAAAAGGCTTC->AGCGTTTAAAAAGGCTTCT
ATCGGGTAGGAGCCCTCAG->TCGGGTAGGAGCCCTCAGA
AAAACAAGTTGTACATATA->AAACAAGTTGTACATATAC
GGCGACGTACGATACAATA->GCGACGTACGATACAATAA
AAAGGCTCAAGAAAGGGGC->AAGGCTCAAGAAAGGGGCC
CAATATAATGGGCCAATAG->AATATAATGGGCCAATAGG
GTTAGGCTTCAGTATCTGC->TTAGGCTTCAGTATCTGCC
TAACGGTCCGAGTCATATT->AACGGTCCGAGTCATATTC
AGTTATTGAGGAATCGTCC->GTTATTGAGGAATCGTCCA
AACCTTGACCGCCTCGCTT->ACCTTGACCGCCTCGCTTG
AGGAGTGTAAAAATGTGCC->GGAGTGTAAAAATGTGCCT
TCGAAGCTTTGATCTCGAG->CGAAGCTTTGATCTCGAGG
GTGTCATGGAATAGCGTAA->TGTCATGGAATAGCGTAAC
TCATCAAAAGGAGTGTAAA->CATCAAAAGGAGTGTAAAA
GTAGTAAATCTAATTGAAC->TAGTAAATCTAATTGAACT
TCTGTGCTGGTTTCTGGCC->CTGTGCTGGTTTCTGGCCT
AGGGTCCTCTCTCGATTCC->GGGTCCTCTCTCGATTCCC
GAGCCTGCAGGAAGCCAGG->AGCCTGCAGGAAGCCAGGT
TGTTCGCGCGCTACCAAGC->GTTCGCGCGCTACCAAGCT
ATGGTTCCGGGCTACTACG->TGGTTCCGGGCTACTACGG
ATTCCCGTTACGGAAGGAT->TTCCCGTTACGGAAGGATC
AGTTGTGGCGACGTACGAT->GTTGTGGCGACGTACGATA
TTGACCTCCGCCAACCACA->TGACCTCCGCCAACCACAT
TCGCTTGAAGAAATCATAT->CGCTTGAAGAAATCATATT
GGAAAGACTCAGATTGATA->GAAAGACTCAGATTGATAT
ATCTGCTCATGTCGCCAGC->TCTGCTCATGTCGCCAGCG
TTCTTCAACTCTTGACCTC->TCTTCAACTCTTGACCTCC
AGCCCTATCACCCCGGAAA->GCCCTATCACCCCGGAAAG
TTACGGAAGGATCTGTCAC->TACGGAAGGATCTGTCACA
TTTAGGCCAAGATTCCTTA->TTAGGCCAAGATTCCTTAT
GCTAATTTCAGACTACTCT->CTAATTTCAGACTACTCTA
GTACACCACCCAGCAAGTT->TACACCACCCAGCAAGTTC
AGGGGCCAGCCTTATGCAA->GGGGCCAGCCTTATGCAAG
TGTTAGTACGTAGACTTCG->GTTAGTACGTAGACTTCGT
TCGGGTAGGAGCCCTCAGA->CGGGTAGGAGCCCTCAGAG
TGCACTCGGTAGTCCCCTC->GCACTCGGTAGTCCCCTCG
AGTAATGAAAGCCGAGTGT->GTAATGAAAGCCGAGTGTG
TAACTAACCGTTATCTTTC->AACTAACCGTTATCTTTCA
TACTGCACCTAACCTTGAC->ACTGCACCTAACCTTGACC
GCCCAGGGTCCTCTCTCGA->CCCAGGGTCCTCTCTCGAT
TCTCGGCTTTGAGCCCTAG->CTCGGCTTTGAGCCCTAGG
CTGTATTCACCCTCATCGG->TGTATTCACCCTCATCGGG
CACCGCGGTGCGGCAGTCG->ACCGCGGTGCGGCAGTCGT
CATGCGCTAGCTCAAGAAA->ATGCGCTAGCTCAAGAAAG
TCCATATGCTCAAGAAAGG->CCATATGCTCAAGAAAGGG
GACTTCGTATTTGCCGGGT->ACTTCGTATTTGCCGGGTA
GGAATAGCGTAACGCGTGT->GAATAGCGTAACGCGTGTT
CACAGAGTCGTCCGGGGGC->ACAGAGTCGTCCGGGGGCA
AAATAATTAACACTGGTAT->AATAATTAACACTGGTATA
TTGATCTCGAGGGTAGAAT->TGATCTCGAGGGTAGAATT
GAAGCTTTGATCTCGAGGG->AAGCTTTGATCTCGAGGGT
GTCGTCCGGGGGCAAGTCA->TCGTCCGGGGGCAAGTCAT
TATTCTGCGGGGAGTTCTG->ATTCTGCGGGGAGTTCTGG
AAATCCGGAAAAACAAGTT->AATCCGGAAAAACAAGTTG
TAAGTTAACTCTATAATCT->AAGTTAACTCTATAATCTC
CAATAACCTAACCTTGACC->AATAACCTAACCTTGACCG
CTTATGCAAGACCTAACCT->TTATGCAAGACCTAACCTT
CTAATTTCAGACTACTCTA->TAATTTCAGACTACTCTAA
GAGTATCGGTCATCGATAA->AGTATCGGTCATCGATAAA
CCCTAACTAACCGTTATCT->CCTAACTAACCGTTATCTT
GGGGCCAGCCTTATGCAAG->GGGCCAGCCTTATGCAAGA
AAAAGGAGTGTAAAAATGT->AAAGGAGTGTAAAAATGTG
AGAATGTCGGCTCGAATTA->GAATGTCGGCTCGAATTAT
CGAGCCTGCAGGAAGCCAG->GAGCCTGCAGGAAGCCAGG
AGTCGTCCGGGGGCAAGTC->GTCGTCCGGGGGCAAGTCA
AGATGGTCGGTAGGCGGGC->GATGGTCGGTAGGCGGGCC
TGAGGATACGCAACTCCCG->GAGGATACGCAACTCCCGT
CAACCACATATGTTGCACT->AACCACATATGTTGCACTC
CAACGGCCTTGCTTCTATG->AACGGCCTTGCTTCTATGA
TGGTGTCCCGGCAACCTAG->GGTGTCCCGGCAACCTAGT
CTGCTTGGTGGTCGTCAGC->TGCTTGGTGGTCGTCAGCG
GACGCTAGTCCCCCAGTCA->ACGCTAGTCCCCCAGTCAG
AGGTCATCCCACATCAATA->GGTCATCCCACATCAATAG
TGTCACATCTCTGTGCTGG->GTCACATCTCTGTGCTGGT
GCCAGGCAGTAAGCGGACC->CCAGGCAGTAAGCGGACCT
CCCGGCAACCTAGTGAAGC->CCGGCAACCTAGTGAAGCT
GGGAAAGTTCCTAGATTCA->GGAAAGTTCCTAGATTCAT
ATTCATGCGCTAGCTCAAG->TTCATGCGCTAGCTCAAGA
TTCCTAGTCACTGCTTGGT->TCCTAGTCACTGCTTGGTG
AAAGGCTTCTCGATAATCT->AAGGCTTCTCGATAATCTA
TGCCGCATGAAGCGCAGTT->GCCGCATGAAGCGCAGTTA
TCGTCCATCCGTGTGGTCG->CGTCCATCCGTGTGGTCGA
GCTTCAGTATCTGCCGGAA->CTTCAGTATCTGCCGGAAT
TCCCGTTTGGCATGGTGTA->CCCGTTTGGCATGGTGTAT
TTTCCGCATTATGCTCACC->TTCCGCATTATGCTCACCT
TGGCCTATACGGGACTCCC->GGCCTATACGGGACTCCCA
CCGGAATTTCCATGTTCAT->CGGAATTTCCATGTTCATT
CTTTGATCTCGAGGGTAGA->TTTGATCTCGAGGGTAGAA
CAGCTGACGCGGATCCACC->AGCTGACGCGGATCCACCG
AAGGTCGGTGGCTATTAAG->AGGTCGGTGGCTATTAAGT
GCCTTGGACTAGCGCTAAA->CCTTGGACTAGCGCTAAAA
CTATCACCCCGGAAAGACT->TATCACCCCGGAAAGACTC
CGCCAGCGACAGTTTACTT->GCCAGCGACAGTTTACTTG
TGACGCGGATCCACCGCGG->GACGCGGATCCACCGCGGT
CCTCTTCACGCGACTGACA->CTCTTCACGCGACTGACAT
ATAGACGCTAGTCCCCCAG->TAGACGCTAGTCCCCCAGT
TACCAAGCTAGCCCTATCA->ACCAAGCTAGCCCTATCAC
GTCCTCTCTCGATTCCCGC->TCCTCTCTCGATTCCCGCA
GTCGGTGGCTATTAAGTCT->TCGGTGGCTATTAAGTCTG
CGTTATCTTTCAACCTCGC->GTTATCTTTCAACCTCGCC
CCAATACCGCCACCCTCGC->CAATACCGCCACCCTCGCT
AACCACATATGTTGCACTC->ACCACATATGTTGCACTCG
TTCATGCGCTAGCTCAAGA->TCATGCGCTAGCTCAAGAA
CGTAACGCGTGTTTCGCTT->GTAACGCGTGTTTCGCTTA
TCCCGACCGTCTGGTACCA->CCCGACCGTCTGGTACCAA
ATTCTCGGCTTTGAGCCCT->TTCTCGGCTTTGAGCCCTA
GGTCATCGATAAATGCTGT->GTCATCGATAAATGCTGTC
TGAAGTGGTAAAAGGATGG->GAAGTGGTAAAAGGATGGG
TTAAGTTAACTCTATAATC->TAAGTTAACTCTATAATCT
CCCTTCCCTATTTTCCACC->CCTTCCCTATTTTCCACCC
CTCTCTCGATTCCCGCATC->TCTCTCGATTCCCGCATCT
CTCTGCCGTTTTATTGAAG->TCTGCCGTTTTATTGAAGT
CGCCTGAAGGTAAGTCCGA->GCCTGAAGGTAAGTCCGAG
CTTCGTATTTGCCGGGTAG->TTCGTATTTGCCGGGTAGT
TAACTCTATAATCTCCGCT->AACTCTATAATCTCCGCTC
GCCAGTTGCTAGCCATCAT->CCAGTTGCTAGCCATCATC
GGACAGACCCCAGGCTATA->GACAGACCCCAGGCTATAA
CTTTGTGCAGCTTATATGT->TTTGTGCAGCTTATATGTG
GGCATGGTGTATATATTAT->GCATGGTGTATATATTATT
TGTGCAGCTTATATGTGTC->GTGCAGCTTATATGTGTCT
GAGTGACGGTGTGGAATGA->AGTGACGGTGTGGAATGAC
TCCACTTAAGTTAACTCTA->CCACTTAAGTTAACTCTAT
GTGTAAAAATGTGCCTTGG->TGTAAAAATGTGCCTTGGA
GACTACTCTAAGTAATGAA->ACTACTCTAAGTAATGAAA
ATAATGGGCCAATAGGTTG->TAATGGGCCAATAGGTTGA
AGCGACAGTTTACTTGTGC->GCGACAGTTTACTTGTGCT
AACCTAGTGAAGCTCATCG->ACCTAGTGAAGCTCATCGG
TTTTATTGAAGTGGTAAAA->TTTATTGAAGTGGTAAAAG
TTGAACTCAGTTCTTCAAC->TGAACTCAGTTCTTCAACT
GCCTAACCAAGTTGTGGCG->CCTAACCAAGTTGTGGCGA
AACGGCCTTGCTTCTATGA->ACGGCCTTGCTTCTATGAT
GCTTCTATGATGCCGTTAT->CTTCTATGATGCCGTTATA
ATCGTACATTGCACACTAA->TCGTACATTGCACACTAAG
TCAAGAAAGGGGCCAGACG->CAAGAAAGGGGCCAGACGC
ATTCCTTATCGAAGCTTTG->TTCCTTATCGAAGCTTTGA
CCGGCAACCTAGTGAAGCT->CGGCAACCTAGTGAAGCTC
TCGCTATACGCTCAAGAAA->CGCTATACGCTCAAGAAAG
GTTAGTACGTAGACTTCGT->TTAGTACGTAGACTTCGTA
ACATTAAGGGACAACTACA->CATTAAGGGACAACTACAT
CTGCCGCATGAAGCGCAGT->TGCCGCATGAAGCGCAGTT
ATCTCTGTGCTGGTTTCTG->TCTCTGTGCTGGTTTCTGG
TTGGTGGTCGTCAGCGGTT->TGGTGGTCGTCAGCGGTTC
AGGATACGCAACTCCCGTA->GGATACGCAACTCCCGTAG
ACCGCCTCTGACCACTAGC->CCGCCTCTGACCACTAGCG
CCGAGGAAGAGGTCATCCC->CGAGGAAGAGGTCATCCCA
CGGTGTGGAATGACAACCT->GGTGTGGAATGACAACCTC
GTATCTGCCGGAATTTCCA->TATCTGCCGGAATTTCCAT
TGACCGCCTCGCTTGAAGA->GACCGCCTCGCTTGAAGAA
CTTGTGCTTTACATCCTTC->TTGTGCTTTACATCCTTCC
TGGTATAGTTATTGAGGAA->GGTATAGTTATTGAGGAAT
ACATATCTGTCGTTAGGCT->CATATCTGTCGTTAGGCTT
ACATAAGTCCTGCCGCATG->CATAAGTCCTGCCGCATGA
TAAATGCTGTCATATCAGC->AAATGCTGTCATATCAGCT
GAACAACCAATACCGCCAC->AACAACCAATACCGCCACC
GACCGCCTCGCTTGAAGAA->ACCGCCTCGCTTGAAGAAA
CGATAAATGCTGTCATATC->GATAAATGCTGTCATATCA
CATGGTGTATATATTATTA->ATGGTGTATATATTATTAC
GCGCAGTTACGCCACTCTC->CGCAGTTACGCCACTCTCC
ATTGATATTCCCGTTACGG->TTGATATTCCCGTTACGGA
AGCCCTAGGGCAAAGAGCG->GCCCTAGGGCAAAGAGCGG
CAACTACATTGTATTGGCC->AACTACATTGTATTGGCCC
TAGCTCAAGAAAGGGGCCA->AGCTCAAGAAAGGGGCCAG
AGTATACTGCACCTAACCT->GTATACTGCACCTAACCTT
TCGGCTCGAATTATGTTAG->CGGCTCGAATTATGTTAGT
GAATGTCGGCTCGAATTAT->AATGTCGGCTCGAATTATG
ACATCAATAGTACATGGAT->CATCAATAGTACATGGATT
ACCTCCGCCAACCACATAT->CCTCCGCCAACCACATATG
GACCGTCTGGTACCAACAA->ACCGTCTGGTACCAACAAC
TTAACGGTCCGAGTCATAT->TAACGGTCCGAGTCATATT
ACTAGCGCACAAGAAATCC->CTAGCGCACAAGAAATCCC
CTTTAGGCCAAGATTCCTT->TTTAGGCCAAGATTCCTTA
CGGGTAGGAGCCCTCAGAG->GGGTAGGAGCCCTCAGAGG
GCCTTATGCAAGACCTAAC->CCTTATGCAAGACCTAACC
ATCTGGACAGACCCCAGGC->TCTGGACAGACCCCAGGCT
CCGTTTTATTGAAGTGGTA->CGTTTTATTGAAGTGGTAA
GTCCCTAACTAACCGTTAT->TCCCTAACTAACCGTTATC
TTAGGCCAAGATTCCTTAT->TAGGCCAAGATTCCTTATC
AGTTCTGGTGTCCCGGCAA->GTTCTGGTGTCCCGGCAAC
ATTCATACCGAAACATGGT->TTCATACCGAAACATGGTT
GTGTGGTCGAATAGACGCT->TGTGGTCGAATAGACGCTA
TTGAGTGACGGTGTGGAAT->TGAGTGACGGTGTGGAATG
CTTTGAGCCCTAGGGCAAA->TTTGAGCCCTAGGGCAAAG
GTCCCCCAGTCAGTGTTCA->TCCCCCAGTCAGTGTTCAT
ATCAGTCGCAATCAGAATG->TCAGTCGCAATCAGAATGT
CCTTGGACTAGCGCTAAAA->CTTGGACTAGCGCTAAAAG
GACTAGCGCTAAAAGGCTC->ACTAGCGCTAAAAGGCTCA
AATGAAAGCCGAGTGTGGT->ATGAAAGCCGAGTGTGGTG
GATTAGAGTCGCGAAAGGT->ATTAGAGTCGCGAAAGGTC
GTCCGGGGGCAAGTCATCG->TCCGGGGGCAAGTCATCGT
CTTCTATGATGCCGTTATA->TTCTATGATGCCGTTATAG
ATGACAACCTCTGACCGAT->TGACAACCTCTGACCGATT
GGCAACCTAGTGAAGCTCA->GCAACCTAGTGAAGCTCAT
CAAGTTGTACATATACAAC->AAGTTGTACATATACAACG
ATATTCACGCAAACCCAAA->TATTCACGCAAACCCAAAT
TCTGTCACATCTCTGTGCT->CTGTCACATCTCTGTGCTG
TCATCGTACATTGCACACT->CATCGTACATTGCACACTA
TGGTCGTCAGCGGTTCCCG->GGTCGTCAGCGGTTCCCGA
TGTCATGGAATAGCGTAAC->GTCATGGAATAGCGTAACG
CTGACCGATTCTCGGCTTT->TGACCGATTCTCGGCTTTG
GTTGTACATATACAACGCC->TTGTACATATACAACGCCA
GAGGGTAGAATTGTCTGGG->AGGGTAGAATTGTCTGGGT
ATCATATTCACGCAAACCC->TCATATTCACGCAAACCCA
AACTCAGTTCTTCAACTCT->ACTCAGTTCTTCAACTCTT
CAGACTACTCTAAGTAATG->AGACTACTCTAAGTAATGA
CCGCCTCCTGCGAGCCTGC->CGCCTCCTGCGAGCCTGCA
CTTGTTAATTGATTCCGGT->TTGTTAATTGATTCCGGTT
TTAGTACGTAGACTTCGTA->TAGTACGTAGACTTCGTAT
AACAACGGCCTTGCTTCTA->ACAACGGCCTTGCTTCTAT
CAGATCAGTCGCAATCAGA->AGATCAGTCGCAATCAGAA
TTGATATTCCCGTTACGGA->TGATATTCCCGTTACGGAA
GCGAAAGGTCGGTGGCTAT->CGAAAGGTCGGTGGCTATT
GACCGCCTCTGACCACTAG->ACCGCCTCTGACCACTAGC
GGCCAGTTGCTAGCCATCA->GCCAGTTGCTAGCCATCAT
TTACCTCAACTTTAGGCCA->TACCTCAACTTTAGGCCAA
GTGCCTTGGACTAGCGCTA->TGCCTTGGACTAGCGCTAA
GCTCATCGGAGGCCAGTTG->CTCATCGGAGGCCAGTTGC
GGACTAGCGCTAAAAGGCT->GACTAGCGCTAAAAGGCTC
ATGCGCTAGCTCAAGAAAG->TGCGCTAGCTCAAGAAAGG
AAGTGGTAAAAGGATGGGT->AGTGGTAAAAGGATGGGTC
TGGAATGACAACCTCTGAC->GGAATGACAACCTCTGACC
GGAGTTCTGGTGTCCCGGC->GAGTTCTGGTGTCCCGGCA
TTCATACCGAAACATGGTT->TCATACCGAAACATGGTTC
TTGTTAATTGATTCCGGTT->TGTTAATTGATTCCGGTTC
ATGTCGCCAGCGACAGTTT->TGTCGCCAGCGACAGTTTA
GGTCCCGTAGCGGACGCAT->GTCCCGTAGCGGACGCATC
CTACGCCTGAAGGTAAGTC->TACGCCTGAAGGTAAGTCC
ACTGAGGATACGCAACTCC->CTGAGGATACGCAACTCCC
TTCGCTTATCATTGCCTAA->TCGCTTATCATTGCCTAAC
AAAGTTCCTAGATTCATGC->AAGTTCCTAGATTCATGCG
TGTTCATTTCTTGTTAATT->GTTCATTTCTTGTTAATTG
GGGCCAGCCTTATGCAAGA->GGCCAGCCTTATGCAAGAC
TCAGAGGATGAAAGCCCTC->CAGAGGATGAAAGCCCTCT
ATGAAAGCCGAGTGTGGTG->TGAAAGCCGAGTGTGGTGC
TGGACAGACCCCAGGCTAT->GGACAGACCCCAGGCTATA
CGCCTCCTGCGAGCCTGCA->GCCTCCTGCGAGCCTGCAG
CCCAGGCTATAAAAGTATC->CCAGGCTATAAAAGTATCT
GTGGTAAAAGGATGGGTCT->TGGTAAAAGGATGGGTCTC
TGTTTCGCTTATCATTGCC->GTTTCGCTTATCATTGCCT
GTAAATCTAATTGAACTCA->TAAATCTAATTGAACTCAG
CCTTCCGTTAACGGTCCGA->CTTCCGTTAACGGTCCGAG
CATATGTTGCACTCGGTAG->ATATGTTGCACTCGGTAGT
TTCTGCGGGGAGTTCTGGT->TCTGCGGGGAGTTCTGGTG
GCCGAGTGTGGTGCAAGTA->CCGAGTGTGGTGCAAGTAC
GTACATTGCACACTAAGTA->TACATTGCACACTAAGTAG
GTTAACTCTATAATCTCCG->TTAACTCTATAATCTCCGC
GCCTGAAGGTAAGTCCGAG->CCTGAAGGTAAGTCCGAGT
TCTGTTCGCGCGCTACCAA->CTGTTCGCGCGCTACCAAG
TTTTACTGAGGATACGCAA->TTTACTGAGGATACGCAAC
CCTCCTGCGAGCCTGCAGG->CTCCTGCGAGCCTGCAGGA
TATGTGTCTTACCTCAACT->ATGTGTCTTACCTCAACTT
CCACATCAATAGTACATGG->CACATCAATAGTACATGGA
ACTCCCAGATCAGTCGCAA->CTCCCAGATCAGTCGCAAT
GGATCCACCGCGGTGCGGC->GATCCACCGCGGTGCGGCA
TAATTAACACTGGTATAGT->AATTAACACTGGTATAGTT
CATATTCACGCAAACCCAA->ATATTCACGCAAACCCAAA
CACCTCTTCACGCGACTGA->ACCTCTTCACGCGACTGAC
GCTTATCATTGCCTAACCA->CTTATCATTGCCTAACCAA
TCAGTTCTTCAACTCTTGA->CAGTTCTTCAACTCTTGAC
TAGGCGGGCCAATATAATG->AGGCGGGCCAATATAATGG
GACATAAGTCCTGCCGCAT->ACATAAGTCCTGCCGCATG
CGCGTCAGCTGTATTCACC->GCGTCAGCTGTATTCACCC
TGATTCCGGTTCTAAATAT->GATTCCGGTTCTAAATATC
GGAAGCCAGGTGTCTGCTT->GAAGCCAGGTGTCTGCTTG
AGTAAATCTAATTGAACTC->GTAAATCTAATTGAACTCA
CGGCCTTGCTTCTATGATG->GGCCTTGCTTCTATGATGC
CTTGACCGCCTCCTGCGAG->TTGACCGCCTCCTGCGAGC
AAGAGCGGAGTATCGGTCA->AGAGCGGAGTATCGGTCAT
GTTTACTTGTGCTTTACAT->TTTACTTGTGCTTTACATC
ATATCCACTTAAGTTAACT->TATCCACTTAAGTTAACTC
CCTCGCCAGCGTTTAAAAA->CTCGCCAGCGTTTAAAAAG
TCCGGAAAAACAAGTTGTA->CCGGAAAAACAAGTTGTAC
TCCTCTCTCGATTCCCGCA->CCTCTCTCGATTCCCGCAT
CTGGACAGACCCCAGGCTA->TGGACAGACCCCAGGCTAT
TTCATTGCTCTTTGTGCAG->TCATTGCTCTTTGTGCAGC
TATACTGCACCTAACCTTG->ATACTGCACCTAACCTTGA
ATTATGTTAGTACGTAGAC->TTATGTTAGTACGTAGACT
GTGGTCGAATAGACGCTAG->TGGTCGAATAGACGCTAGT
CTGGTTTCTGGCCTATACG->TGGTTTCTGGCCTATACGG
ACCTAGTGAAGCTCATCGG->CCTAGTGAAGCTCATCGGA
GGTGCAAGTACACCACCCA->GTGCAAGTACACCACCCAG
TCGCGAAAGGTCGGTGGCT->CGCGAAAGGTCGGTGGCTA
TGGCTAATTTCAGACTACT->GGCTAATTTCAGACTACTC
GCCAGGTGTCTGCTTGCAC->CCAGGTGTCTGCTTGCACA
AGCGGAGTATCGGTCATCG->GCGGAGTATCGGTCATCGA
CCAGGTGTCTGCTTGCACA->CAGGTGTCTGCTTGCACAT
GCCCTAGGGCAAAGAGCGG->CCCTAGGGCAAAGAGCGGA
TCTGCCGTTTTATTGAAGT->CTGCCGTTTTATTGAAGTG
TCGCTCGACCACGCGTCAG->CGCTCGACCACGCGTCAGC
AAGGAGTGTAAAAATGTGC->AGGAGTGTAAAAATGTGCC
CTACATTGTATTGGCCCAT->TACATTGTATTGGCCCATC
CCGCATCTGCTCATGTCGC->CGCATCTGCTCATGTCGCC
ATAATCTACGCCTGAAGGT->TAATCTACGCCTGAAGGTA
CTCGCCAGCGTTTAAAAAG->TCGCCAGCGTTTAAAAAGG
TCGAGGGTAGAATTGTCTG->CGAGGGTAGAATTGTCTGG
TGAAAGCCCTCTGCCGTTT->GAAAGCCCTCTGCCGTTTT
CTCAACTTTAGGCCAAGAT->TCAACTTTAGGCCAAGATT
GCGTGTTTCGCTTATCATT->CGTGTTTCGCTTATCATTG
CGTTAGGCTTCAGTATCTG->GTTAGGCTTCAGTATCTGC
AATAGGTTGAGTGACGGTG->ATAGGTTGAGTGACGGTGT
GGTCGGTAGGCGGGCCAAT->GTCGGTAGGCGGGCCAATA
CTCCGCCAACCACATATGT->TCCGCCAACCACATATGTT
GCCGCATGAAGCGCAGTTA->CCGCATGAAGCGCAGTTAC
CGCCACTCTCCCACTATTT->GCCACTCTCCCACTATTTT
ATTGCACACTAAGTAGCCT->TTGCACACTAAGTAGCCTA
GGCCTTGCTTCTATGATGC->GCCTTGCTTCTATGATGCC
CGGAAAGACTCAGATTGAT->GGAAAGACTCAGATTGATA
TTCATTTCTTGTTAATTGA->TCATTTCTTGTTAATTGAT
CCGCCAACCACATATGTTG->CGCCAACCACATATGTTGC
ACATTGCACACTAAGTAGC->CATTGCACACTAAGTAGCC
GTCCCGTAGCGGACGCATC->TCCCGTAGCGGACGCATCC
TTCTTGTTAATTGATTCCG->TCTTGTTAATTGATTCCGG
ACCTAACCTTGACCGCCTC->CCTAACCTTGACCGCCTCC,CCTAACCTTGACCGCCTCT,CCTAACCTTGACCGCCTCG,CCTAACCTTGACCGCCTCC
ATTTGCCGGGTAGTAAATC->TTTGCCGGGTAGTAAATCT
TCAGCGGTTCCCGACCGTC->CAGCGGTTCCCGACCGTCT
GTAACGCGTGTTTCGCTTA->TAACGCGTGTTTCGCTTAT
ATGAAAGCCCTCTGCCGTT->TGAAAGCCCTCTGCCGTTT
GTAAGCGGACCTAACCTTG->TAAGCGGACCTAACCTTGA
GTAATGAAAGCCGAGTGTG->TAATGAAAGCCGAGTGTGG
AGTGAAGCTCATCGGAGGC->GTGAAGCTCATCGGAGGCC
ATCTGTCGTTAGGCTTCAG->TCTGTCGTTAGGCTTCAGT
CTCAAGAAAGGGGCCAGCC->TCAAGAAAGGGGCCAGCCT
CGATTCCCGCATCTGCTCA->GATTCCCGCATCTGCTCAT
AACGCCAGCTGACGCGGAT->ACGCCAGCTGACGCGGATC
GTGGTCGTCAGCGGTTCCC->TGGTCGTCAGCGGTTCCCG
TATGCAAGACCTAACCTTG->ATGCAAGACCTAACCTTGA
AGGTCGGTGGCTATTAAGT->GGTCGGTGGCTATTAAGTC
AAGCCCTCTGCCGTTTTAT->AGCCCTCTGCCGTTTTATT
ATAATCTCCGCTCAGTGAA->TAATCTCCGCTCAGTGAAC
CCTATACGGGACTCCCAGA->CTATACGGGACTCCCAGAT
CAGCTTATATGTGTCTTAC->AGCTTATATGTGTCTTACC
CGCGCGCTACCAAGCTAGC->GCGCGCTACCAAGCTAGCC
AGGAAGCCAGGTGTCTGCT->GGAAGCCAGGTGTCTGCTT
ACGCATCCGAGCACAGAGT->CGCATCCGAGCACAGAGTC
GGAAGAGGTCATCCCACAT->GAAGAGGTCATCCCACATC
CAAGTTCCCTAACAAGGTT->AAGTTCCCTAACAAGGTTT
CTTCTCGATAATCTACGCC->TTCTCGATAATCTACGCCT
CCACATCTGTTCGCCAATT->CACATCTGTTCGCCAATTG
GTATTCACCCTCATCGGGT->TATTCACCCTCATCGGGTA
ACACCACCCAGCAAGTTCC->CACCACCCAGCAAGTTCCC
GCATCCGAGCACAGAGTCG->CATCCGAGCACAGAGTCGT
CGAAACATGGTTCCGGGCT->GAAACATGGTTCCGGGCTA
CTAAAAGGCTCAAGAAAGG->TAAAAGGCTCAAGAAAGGG
GGCTCAAGAAAGGGGCCAG->GCTCAAGAAAGGGGCCAGG
TCAGAATGTCGGCTCGAAT->CAGAATGTCGGCTCGAATT
TCAGTGTTCATTTCTTGTT->CAGTGTTCATTTCTTGTTA
TTGATTCCGGTTCTAAATA->TGATTCCGGTTCTAAATAT
TCGGCTTTGAGCCCTAGGG->CGGCTTTGAGCCCTAGGGC
GTCATCGTACATTGCACAC->TCATCGTACATTGCACACT
TGCAGGAAGCCAGGTGTCT->GCAGGAAGCCAGGTGTCTG
AAGACTCAGATTGATATTC->AGACTCAGATTGATATTCC
AGTCATCGTACATTGCACA->GTCATCGTACATTGCACAC
GTTTAAAAAGGCTTCTCGA->TTTAAAAAGGCTTCTCGAT
CGCGCTACCAAGCTAGCCC->GCGCTACCAAGCTAGCCCT
CAGACCCCAGGCTATAAAA->AGACCCCAGGCTATAAAAG
GCGGCAGTCGTGTCATGGA->CGGCAGTCGTGTCATGGAA
TGTCCCGGCAACCTAGTGA->GTCCCGGCAACCTAGTGAA
CTGCTCATGTCGCCAGCGA->TGCTCATGTCGCCAGCGAC
GCTCAAGAAAGGGGCCAGT->CTCAAGAAAGGGGCCAGTA
TTGCCTAACCAAGTTGTGG->TGCCTAACCAAGTTGTGGC
GCCGGGTAGTAAATCTAAT->CCGGGTAGTAAATCTAATT
CCTAACCTTGACCGCCTCT->CTAACCTTGACCGCCTCTG
ACCACCCAGCAAGTTCCCT->CCACCCAGCAAGTTCCCTA
GCTCAGTGAACAACCAATA->CTCAGTGAACAACCAATAC
TACCTCAACTTTAGGCCAA->ACCTCAACTTTAGGCCAAG
GGTAGTAAATCTAATTGAA->GTAGTAAATCTAATTGAAC
TCGTTAGGCTTCAGTATCT->CGTTAGGCTTCAGTATCTG
CCTCTGACCGATTCTCGGC->CTCTGACCGATTCTCGGCT
TTAGAGTCGCGAAAGGTCG->TAGAGTCGCGAAAGGTCGG
CTTGACCGCCTCGCTTGAA->TTGACCGCCTCGCTTGAAG
TGAAGGTAAGTCCGAGTTC->GAAGGTAAGTCCGAGTTCG
GAAAGGGGCCAGGCAGTAA->AAAGGGGCCAGGCAGTAAG
ATATTCTGCGGGGAGTTCT->TATTCTGCGGGGAGTTCTG
TCATCCCACATCAATAGTA->CATCCCACATCAATAGTAC
AGTTCGCTATACGCTCAAG->GTTCGCTATACGCTCAAGA
CTAACAAGGTTTTAGTCCC->TAACAAGGTTTTAGTCCCT
TCCGGGCTACTACGGGAAA->CCGGGCTACTACGGGAAAG
GTAGGAGCCCTCAGAGGAT->TAGGAGCCCTCAGAGGATG
AGTGACGGTGTGGAATGAC->GTGACGGTGTGGAATGACA
CGGACCTAACCTTGACCGC->GGACCTAACCTTGACCGCC
AATCGTCCATCCGTGTGGT->ATCGTCCATCCGTGTGGTC
AGCCTATTCCAGGTCAATC->GCCTATTCCAGGTCAATCT
CACCCTCATCGGGTAGGAG->ACCCTCATCGGGTAGGAGC
AAAAGGATGGGTCTCGCTG->AAAGGATGGGTCTCGCTGT
CAATAGTACATGGATTCAT->AATAGTACATGGATTCATA
GGCTATAAAAGTATCTGAT->GCTATAAAAGTATCTGATT
TAATCTCCGCTCAGTGAAC->AATCTCCGCTCAGTGAACA
GCAAGTACACCACCCAGCA->CAAGTACACCACCCAGCAA
AGCGGTTCCCGACCGTCTG->GCGGTTCCCGACCGTCTGG
TCGGTCATCGATAAATGCT->CGGTCATCGATAAATGCTG
GGCCAGCCTTATGCAAGAC->GCCAGCCTTATGCAAGACC
ACCCAAATAATTAACACTG->CCCAAATAATTAACACTGG
AATGGGCCAATAGGTTGAG->ATGGGCCAATAGGTTGAGT
GGTCATCCCACATCAATAG->GTCATCCCACATCAATAGT
GAAGAAATCATATTCACGC->AAGAAATCATATTCACGCA
CTGTCACATCTCTGTGCTG->TGTCACATCTCTGTGCTGG
ACCAAGTTGTGGCGACGTA->CCAAGTTGTGGCGACGTAC
AACTTTAGGCCAAGATTCC->ACTTTAGGCCAAGATTCCT
GCTAGCCCTATCACCCCGG->CTAGCCCTATCACCCCGGA
TTGTACATATACAACGCCA->TGTACATATACAACGCCAG
GCGCCCAGGGTCCTCTCTC->CGCCCAGGGTCCTCTCTCG
CGGCAACCTAGTGAAGCTC->GGCAACCTAGTGAAGCTCA
TGCTCACCTCTTCACGCGA->GCTCACCTCTTCACGCGAC
AGACCTAACCTTGACCGCC->GACCTAACCTTGACCGCCT
ACCAATACCGCCACCCTCG->CCAATACCGCCACCCTCGC
AAAGGGGCCAGACGCCTCA->AAGGGGCCAGACGCCTCAA
TCCTTCCGTTAACGGTCCG->CCTTCCGTTAACGGTCCGA
TTTTAGTCCCTAACTAACC->TTTAGTCCCTAACTAACCG
CCCTCATCGGGTAGGAGCC->CCTCATCGGGTAGGAGCCC
GCCGGAATTTCCATGTTCA->CCGGAATTTCCATGTTCAT
AGCTTATATGTGTCTTACC->GCTTATATGTGTCTTACCT
ATCATTGCCTAACCAAGTT->TCATTGCCTAACCAAGTTG
ACGTAGACTTCGTATTTGC->CGTAGACTTCGTATTTGCC
AAGATGGTCGGTAGGCGGG->AGATGGTCGGTAGGCGGGC
AGAGTCGTCCGGGGGCAAG->GAGTCGTCCGGGGGCAAGT
TGGTAAAAGGATGGGTCTC->GGTAAAAGGATGGGTCTCG
AAGTAATGAAAGCCGAGTG->AGTAATGAAAGCCGAGTGT
TATACGCTCAAGAAAGGGG->ATACGCTCAAGAAAGGGGC
CAGGTGTCTGCTTGCACAT->AGGTGTCTGCTTGCACATT
ATTATTACGACATAAGTCC->TTATTACGACATAAGTCCT
TCTAAATATCCACTTAAGT->CTAAATATCCACTTAAGTT
GCAGTAAGCGGACCTAACC->CAGTAAGCGGACCTAACCT
GGGCTACTACGGGAAAGTT->GGCTACTACGGGAAAGTTC
ATTAAGGGACAACTACATT->TTAAGGGACAACTACATTG
TAAATATCCACTTAAGTTA->AAATATCCACTTAAGTTAA
CCAGCAAGTTCCCTAACAA->CAGCAAGTTCCCTAACAAG
AGTTGTACATATACAACGC->GTTGTACATATACAACGCC
TCTTACCTCAACTTTAGGC->CTTACCTCAACTTTAGGCC
GGTGGCTATTAAGTCTGTT->GTGGCTATTAAGTCTGTTC
GGGCCAATAGGTTGAGTGA->GGCCAATAGGTTGAGTGAC
ATAGGTTGAGTGACGGTGT->TAGGTTGAGTGACGGTGTG
AATCTAATTGAACTCAGTT->ATCTAATTGAACTCAGTTC
TCGAATAGACGCTAGTCCC->CGAATAGACGCTAGTCCCC
TCTGGTGTCCCGGCAACCT->CTGGTGTCCCGGCAACCTA
TCCCCTCGTTTAAACCACA->CCCCTCGTTTAAACCACAT
GCGGATCCACCGCGGTGCG->CGGATCCACCGCGGTGCGG
CCCGACCGTCTGGTACCAA->CCGACCGTCTGGTACCAAC
AACCTCGCCAGCGTTTAAA->ACCTCGCCAGCGTTTAAAA
TTCCCGCATCTGCTCATGT->TCCCGCATCTGCTCATGTC
GTCAGTGTTCATTTCTTGT->TCAGTGTTCATTTCTTGTT
ACGCGGATCCACCGCGGTG->CGCGGATCCACCGCGGTGC
ATTTCAGACTACTCTAAGT->TTTCAGACTACTCTAAGTA
CCGCCTCGCTTGAAGAAAT->CGCCTCGCTTGAAGAAATC
TCTGGTACCAACAACGGCC->CTGGTACCAACAACGGCCT
GAATAGACGCTAGTCCCCC->AATAGACGCTAGTCCCCCA
CCAGTCAGTGTTCATTTCT->CAGTCAGTGTTCATTTCTT
AGAGTACCAAAGATGGTCG->GAGTACCAAAGATGGTCGG
CCTTGACCGCCTCTGACCA->CTTGACCGCCTCTGACCAC
AGCTATACCTCCATATGCT->GCTATACCTCCATATGCTC
ACCGATTCTCGGCTTTGAG->CCGATTCTCGGCTTTGAGC
AGACTTCGTATTTGCCGGG->GACTTCGTATTTGCCGGGT
ATTGCCTAACCAAGTTGTG->TTGCCTAACCAAGTTGTGG
GAGCACAGAGTCGTCCGGG->AGCACAGAGTCGTCCGGGG
GACCGATTCTCGGCTTTGA->ACCGATTCTCGGCTTTGAG
TTTTCCACCCCATCCGAGG->TTTCCACCCCATCCGAGGA
GTCGAATAGACGCTAGTCC->TCGAATAGACGCTAGTCCC
CCTTGCTTCTATGATGCCG->CTTGCTTCTATGATGCCGT
ATATGTTGCACTCGGTAGT->TATGTTGCACTCGGTAGTC
ATTGGCCCATCTAAATCCG->TTGGCCCATCTAAATCCGG
GGGGCCAGGCAGTAAGCGG->GGGCCAGGCAGTAAGCGGA
AAGTATCTGATTAGAGTCG->AGTATCTGATTAGAGTCGC
ACTAAGTAGCCTATTCCAG->CTAAGTAGCCTATTCCAGG
GGGTAGTAAATCTAATTGA->GGTAGTAAATCTAATTGAA
CATGTCGCCAGCGACAGTT->ATGTCGCCAGCGACAGTTT
CATTGTATTGGCCCATCTA->ATTGTATTGGCCCATCTAA
TATTTGCCGGGTAGTAAAT->ATTTGCCGGGTAGTAAATC
AAAGAGCGGAGTATCGGTC->AAGAGCGGAGTATCGGTCA
TTTCCATGTTCATTGCTCT->TTCCATGTTCATTGCTCTT
AGGAGCCCTCAGAGGATGA->GGAGCCCTCAGAGGATGAA
GCTAGCTCAAGAAAGGGGC->CTAGCTCAAGAAAGGGGCC
ATAGCGTAACGCGTGTTTC->TAGCGTAACGCGTGTTTCG
TAAGTAATGAAAGCCGAGT->AAGTAATGAAAGCCGAGTG
GAGGCCAGTTGCTAGCCAT->AGGCCAGTTGCTAGCCATC
CTATGATGCCGTTATAGAG->TATGATGCCGTTATAGAGT
TTTACATCCTTCCGTTAAC->TTACATCCTTCCGTTAACG
AATTGAACTCAGTTCTTCA->ATTGAACTCAGTTCTTCAA
CAGCAAGTTCCCTAACAAG->AGCAAGTTCCCTAACAAGG
CCTAGATTCATGCGCTAGC->CTAGATTCATGCGCTAGCT
ACGGGACTCCCAGATCAGT->CGGGACTCCCAGATCAGTC
GCTCATGTCGCCAGCGACA->CTCATGTCGCCAGCGACAG
GGAATTTCCATGTTCATTG->GAATTTCCATGTTCATTGC
ACTGCACCTAACCTTGACC->CTGCACCTAACCTTGACCG
GGACAACTACATTGTATTG->GACAACTACATTGTATTGG
CACTGCTTGGTGGTCGTCA->ACTGCTTGGTGGTCGTCAG
TTATGCAAGACCTAACCTT->TATGCAAGACCTAACCTTG
AACTCTATAATCTCCGCTC->ACTCTATAATCTCCGCTCA
CCCAGATCAGTCGCAATCA->CCAGATCAGTCGCAATCAG
GACAACTACATTGTATTGG->ACAACTACATTGTATTGGC
CGCCAACCACATATGTTGC->GCCAACCACATATGTTGCA
GATCAGTCGCAATCAGAAT->ATCAGTCGCAATCAGAATG
GCTCAAGAAAGGGGCCAGA->CTCAAGAAAGGGGCCAGAC
CCGCCTCCCGTTTGGCATG->CGCCTCCCGTTTGGCATGG
CCTAACAAGGTTTTAGTCC->CTAACAAGGTTTTAGTCCC
AAGAAAGGGGCCAGGCAGT->AGAAAGGGGCCAGGCAGTA
CCTCCCGTTTGGCATGGTG->CTCCCGTTTGGCATGGTGT
CGTTATAGAGTACCAAAGA->GTTATAGAGTACCAAAGAT
ACGGGAAAGTTCCTAGATT->CGGGAAAGTTCCTAGATTC
GTGGCTATTAAGTCTGTTC->TGGCTATTAAGTCTGTTCG
CTGGGTCCCGTAGCGGACG->TGGGTCCCGTAGCGGACGC
TGTATTCACCCTCATCGGG->GTATTCACCCTCATCGGGT
ACAACGGCCTTGCTTCTAT->CAACGGCCTTGCTTCTATG
AGTCTGTTCGCGCGCTACC->GTCTGTTCGCGCGCTACCA
CATTGCTCTTTGTGCAGCT->ATTGCTCTTTGTGCAGCTT
ATATCAGCTATGTCACATA->TATCAGCTATGTCACATAT
CCCAGGGTCCTCTCTCGAT->CCAGGGTCCTCTCTCGATT
TCGCGCGCTACCAAGCTAG->CGCGCGCTACCAAGCTAGC
AAGGGGCCAGGCAGTAAGC->AGGGGCCAGGCAGTAAGCG
GCAACTCCCGTAGCTATAC->CAACTCCCGTAGCTATACC
TCATATCAGCTATGTCACA->CATATCAGCTATGTCACAT
TAGGCCAAGATTCCTTATC->AGGCCAAGATTCCTTATCG
GATGAAAGCCCTCTGCCGT->ATGAAAGCCCTCTGCCGTT
GACGGTGTGGAATGACAAC->ACGGTGTGGAATGACAACC
GGTCCTCTCTCGATTCCCG->GTCCTCTCTCGATTCCCGC
GTATATATTATTACGACAT->TATATATTATTACGACATA
TATCGGTCATCGATAAATG->ATCGGTCATCGATAAATGC
TTACGACATAAGTCCTGCC->TACGACATAAGTCCTGCCG
ATAAAAGTATCTGATTAGA->TAAAAGTATCTGATTAGAG
GCTATAAAAGTATCTGATT->CTATAAAAGTATCTGATTA
TACTACGGGAAAGTTCCTA->ACTACGGGAAAGTTCCTAG
AACACTGGTATAGTTATTG->ACACTGGTATAGTTATTGA
TTGAAGTGGTAAAAGGATG->TGAAGTGGTAAAAGGATGG
CCTCAATAACCTAACCTTG->CTCAATAACCTAACCTTGA
ATACCGAAACATGGTTCCG->TACCGAAACATGGTTCCGG
TAACACTGGTATAGTTATT->AACACTGGTATAGTTATTG
TGTCTTACCTCAACTTTAG->GTCTTACCTCAACTTTAGG
GAAAGGGGCCAGACGCCTC->AAAGGGGCCAGACGCCTCA
CCGATTCTCGGCTTTGAGC->CGATTCTCGGCTTTGAGCC
AATAGCGTAACGCGTGTTT->ATAGCGTAACGCGTGTTTC
GACGCCTCAATAACCTAAC->ACGCCTCAATAACCTAACC
CGACATAAGTCCTGCCGCA->GACATAAGTCCTGCCGCAT
CGGAAAAACAAGTTGTACA->GGAAAAACAAGTTGTACAT
AATTGATTCCGGTTCTAAA->ATTGATTCCGGTTCTAAAT
GATAAATGCTGTCATATCA->ATAAATGCTGTCATATCAG
GATTCCGGTTCTAAATATC->ATTCCGGTTCTAAATATCC
TGTGCCTTGGACTAGCGCT->GTGCCTTGGACTAGCGCTA
TCACCCTCATCGGGTAGGA->CACCCTCATCGGGTAGGAG
GCGGACCTAACCTTGACCG->CGGACCTAACCTTGACCGC
ATTGAACTCAGTTCTTCAA->TTGAACTCAGTTCTTCAAC
TGTTAATTGATTCCGGTTC->GTTAATTGATTCCGGTTCT
CTCGACCACGCGTCAGCTG->TCGACCACGCGTCAGCTGT
ATCAGAATGTCGGCTCGAA->TCAGAATGTCGGCTCGAAT
TTGCTCTTTGTGCAGCTTA->TGCTCTTTGTGCAGCTTAT
CCGGAAAGACTCAGATTGA->CGGAAAGACTCAGATTGAT
ACCTTGACCGCCTCTGACC->CCTTGACCGCCTCTGACCA
CCAATAGGTTGAGTGACGG->CAATAGGTTGAGTGACGGT
GAGCCCTAGGGCAAAGAGC->AGCCCTAGGGCAAAGAGCG
GCCAGCGTTTAAAAAGGCT->CCAGCGTTTAAAAAGGCTT
CCAAGTTGTGGCGACGTAC->CAAGTTGTGGCGACGTACG
ATCGTCCATCCGTGTGGTC->TCGTCCATCCGTGTGGTCG
TTCTAAATATCCACTTAAG->TCTAAATATCCACTTAAGT
AGGGGCCAGGCAGTAAGCG->GGGGCCAGGCAGTAAGCGG
CTAAGTAGCCTATTCCAGG->TAAGTAGCCTATTCCAGGT
TATCTGATTAGAGTCGCGA->ATCTGATTAGAGTCGCGAA
TGACCACTAGCGCACAAGA->GACCACTAGCGCACAAGAA
CATTTCTTGTTAATTGATT->ATTTCTTGTTAATTGATTC
CCAGCCTTATGCAAGACCT->CAGCCTTATGCAAGACCTA
TATTGAAGTGGTAAAAGGA->ATTGAAGTGGTAAAAGGAT
CCGTTAACGGTCCGAGTCA->CGTTAACGGTCCGAGTCAT
CGGGCCAATATAATGGGCC->GGGCCAATATAATGGGCCA
TAAGCGGACCTAACCTTGA->AAGCGGACCTAACCTTGAC
AAGGTTTTAGTCCCTAACT->AGGTTTTAGTCCCTAACTA
CTCCCGTAGCTATACCTCC->TCCCGTAGCTATACCTCCA
TGTGGCGACGTACGATACA->GTGGCGACGTACGATACAA
CCGTAGCGGACGCATCCGA->CGTAGCGGACGCATCCGAG
TCTCTCGATTCCCGCATCT->CTCTCGATTCCCGCATCTG
ATACTGCACCTAACCTTGA->TACTGCACCTAACCTTGAC
CAACTCCCGTAGCTATACC->AACTCCCGTAGCTATACCT
TGCTAGCCATCATCAAAAG->GCTAGCCATCATCAAAAGG
TCACATATCTGTCGTTAGG->CACATATCTGTCGTTAGGC
ACGTACGATACAATAATCT->CGTACGATACAATAATCTG
GCCAGACGCCTCAATAACC->CCAGACGCCTCAATAACCT
CGCGCCCAGGGTCCTCTCT->GCGCCCAGGGTCCTCTCTC
GTCGTCAGCGGTTCCCGAC->TCGTCAGCGGTTCCCGACC
TCCCGTTACGGAAGGATCT->CCCGTTACGGAAGGATCTG
TTACGCCACTCTCCCACTA->TACGCCACTCTCCCACTAT
ACCTTGACCGCCTCGCTTG->CCTTGACCGCCTCGCTTGA
CCAGCGTTTAAAAAGGCTT->CAGCGTTTAAAAAGGCTTC
CAAGTTGTGGCGACGTACG->AAGTTGTGGCGACGTACGA
TGGTGGTCGTCAGCGGTTC->GGTGGTCGTCAGCGGTTCC
GTTATAGAGTACCAAAGAT->TTATAGAGTACCAAAGATG
GCATGGTGTATATATTATT->CATGGTGTATATATTATTA
TTCCCGTTACGGAAGGATC->TCCCGTTACGGAAGGATCT
CAGTCAGTGTTCATTTCTT->AGTCAGTGTTCATTTCTTG
TAATTGATTCCGGTTCTAA->AATTGATTCCGGTTCTAAA
ATCTCCGCTCAGTGAACAA->TCTCCGCTCAGTGAACAAC
AATTAACACTGGTATAGTT->ATTAACACTGGTATAGTTA
GGCCAATAGGTTGAGTGAC->GCCAATAGGTTGAGTGACG
CTCTTGACCTCCGCCAACC->TCTTGACCTCCGCCAACCA
CCCATCCGAGGAAGAGGTC->CCATCCGAGGAAGAGGTCA
TTGAGCCCTAGGGCAAAGA->TGAGCCCTAGGGCAAAGAG
TGGTTCCGGGCTACTACGG->GGTTCCGGGCTACTACGGG
CGGCTCGAATTATGTTAGT->GGCTCGAATTATGTTAGTA
CTCCCGTTTGGCATGGTGT->TCCCGTTTGGCATGGTGTA
GCAAGTTCCCTAACAAGGT->CAAGTTCCCTAACAAGGTT
CCACCGCGGTGCGGCAGTC->CACCGCGGTGCGGCAGTCG
ATCACCCCGGAAAGACTCA->TCACCCCGGAAAGACTCAG
TACAATAATCTGGACAGAC->ACAATAATCTGGACAGACC
TGAAGAAATCATATTCACG->GAAGAAATCATATTCACGC
GGCAGTCGTGTCATGGAAT->GCAGTCGTGTCATGGAATA
CCCGCATCTGCTCATGTCG->CCGCATCTGCTCATGTCGC
ACGCTCAAGAAAGGGGCCA->CGCTCAAGAAAGGGGCCAG
CCCTCTGCCGTTTTATTGA->CCTCTGCCGTTTTATTGAA
AATAACCTAACCTTGACCG->ATAACCTAACCTTGACCGC
TCTAATTGAACTCAGTTCT->CTAATTGAACTCAGTTCTT
CGAGTCATATTCTGCGGGG->GAGTCATATTCTGCGGGGA
CCAACAACGGCCTTGCTTC->CAACAACGGCCTTGCTTCT
TTGACCGCCTCGCTTGAAG->TGACCGCCTCGCTTGAAGA
GTGTATATATTATTACGAC->TGTATATATTATTACGACA
ACCGTCTGGTACCAACAAC->CCGTCTGGTACCAACAACG
CCTATCACCCCGGAAAGAC->CTATCACCCCGGAAAGACT
TGCCGTTTTATTGAAGTGG->GCCGTTTTATTGAAGTGGT
GACCTAACCTTGACCGCCT->ACCTAACCTTGACCGCCTC,ACCTAACCTTGACCGCCTC
AAAGGATGGGTCTCGCTGT->AAGGATGGGTCTCGCTGTC
TATTCACCCTCATCGGGTA->ATTCACCCTCATCGGGTAG
TGCCTAACCAAGTTGTGGC->GCCTAACCAAGTTGTGGCG
GCTATACCTCCATATGCTC->CTATACCTCCATATGCTCA
AGTATCTGCCGGAATTTCC->GTATCTGCCGGAATTTCCA
ACAATAATCTGGACAGACC->CAATAATCTGGACAGACCC
CGCACAAGAAATCCCCTTC->GCACAAGAAATCCCCTTCC
TTTATTGAAGTGGTAAAAG->TTATTGAAGTGGTAAAAGG
CTGTCATATCAGCTATGTC->TGTCATATCAGCTATGTCA
TTGCACTCGGTAGTCCCCT->TGCACTCGGTAGTCCCCTC
GACCGCCTCCCGTTTGGCA->ACCGCCTCCCGTTTGGCAT
GGAAGGATCTGTCACATCT->GAAGGATCTGTCACATCTC
GTCTGCTTGCACATTTCCT->TCTGCTTGCACATTTCCTA
ATCTACGCCTGAAGGTAAG->TCTACGCCTGAAGGTAAGT
CAGCGACAGTTTACTTGTG->AGCGACAGTTTACTTGTGC
TTGACCGCCTCTGACCACT->TGACCGCCTCTGACCACTA
CGAGGAAGAGGTCATCCCA->GAGGAAGAGGTCATCCCAC
AGTGTTCATTTCTTGTTAA->GTGTTCATTTCTTGTTAAT
CTGCCGTTTTATTGAAGTG->TGCCGTTTTATTGAAGTGG
CGCGACTGACATTAAGGGA->GCGACTGACATTAAGGGAC
ACTCGGTAGTCCCCTCGTT->CTCGGTAGTCCCCTCGTTT
CAACCAATACCGCCACCCT->AACCAATACCGCCACCCTC
TTTCTGGCCTATACGGGAC->TTCTGGCCTATACGGGACT
GTTGCTAGCCATCATCAAA->TTGCTAGCCATCATCAAAA
TGCTGGTTTCTGGCCTATA->GCTGGTTTCTGGCCTATAC
AGTACACCACCCAGCAAGT->GTACACCACCCAGCAAGTT
GCAAACCCAAATAATTAAC->CAAACCCAAATAATTAACA
GGAAAAACAAGTTGTACAT->GAAAAACAAGTTGTACATA
TTTAAACCACATCTGTTCG->TTAAACCACATCTGTTCGC
TTCCACCCCATCCGAGGAA->TCCACCCCATCCGAGGAAG
CGGTCATCGATAAATGCTG->GGTCATCGATAAATGCTGT
CTGTTCGCCAATTGGCGGT->TGTTCGCCAATTGGCGGTC
GCGACGTACGATACAATAA->CGACGTACGATACAATAAT
TGTCATATCAGCTATGTCA->GTCATATCAGCTATGTCAC
CATCGGAGGCCAGTTGCTA->ATCGGAGGCCAGTTGCTAG
AAGTTCCTAGATTCATGCG->AGTTCCTAGATTCATGCGC
CAGAGTCGTCCGGGGGCAA->AGAGTCGTCCGGGGGCAAG
GAAGCGCAGTTACGCCACT->AAGCGCAGTTACGCCACTC
TCATTGCCTAACCAAGTTG->CATTGCCTAACCAAGTTGT
CGCCAGCTGACGCGGATCC->GCCAGCTGACGCGGATCCA
AATCTTTCCGCATTATGCT->ATCTTTCCGCATTATGCTC
CCATCCGTGTGGTCGAATA->CATCCGTGTGGTCGAATAG
TAGCCCTATCACCCCGGAA->AGCCCTATCACCCCGGAAA
ACAACCTCTGACCGATTCT->CAACCTCTGACCGATTCTC
ACTAGCGCTAAAAGGCTCA->CTAGCGCTAAAAGGCTCAA
CTACTCTAAGTAATGAAAG->TACTCTAAGTAATGAAAGC
GCGACAGTTTACTTGTGCT->CGACAGTTTACTTGTGCTT
CTAACCTTGACCGCCTCCC->TAACCTTGACCGCCTCCCG
TGCTGTCATATCAGCTATG->GCTGTCATATCAGCTATGT
CGACTGACATTAAGGGACA->GACTGACATTAAGGGACAA
CGCGAAAGGTCGGTGGCTA->GCGAAAGGTCGGTGGCTAT
GCAGGAAGCCAGGTGTCTG->CAGGAAGCCAGGTGTCTGC
GATGGTCGGTAGGCGGGCC->ATGGTCGGTAGGCGGGCCA
CTTGAAGAAATCATATTCA->TTGAAGAAATCATATTCAC
AGTCACTGCTTGGTGGTCG->GTCACTGCTTGGTGGTCGT
GACCACTAGCGCACAAGAA->ACCACTAGCGCACAAGAAA
CTGGTGTCCCGGCAACCTA->TGGTGTCCCGGCAACCTAG
GAAAGGGGCCAGCCTTATG->AAAGGGGCCAGCCTTATGC
AAGACCTAACCTTGACCGC->AGACCTAACCTTGACCGCC
ACTACGGGAAAGTTCCTAG->CTACGGGAAAGTTCCTAGA
CACCCAGCAAGTTCCCTAA->ACCCAGCAAGTTCCCTAAC
ATTTTCCACCCCATCCGAG->TTTTCCACCCCATCCGAGG
AGGATGAAAGCCCTCTGCC->GGATGAAAGCCCTCTGCCG
TGAACTCAGTTCTTCAACT->GAACTCAGTTCTTCAACTC
CATGTTCATTGCTCTTTGT->ATGTTCATTGCTCTTTGTG
GCGAGCCTGCAGGAAGCCA->CGAGCCTGCAGGAAGCCAG
TACGCCACTCTCCCACTAT->ACGCCACTCTCCCACTATT
TACAACGCCAGCTGACGCG->ACAACGCCAGCTGACGCGG
TGTGGTGCAAGTACACCAC->GTGGTGCAAGTACACCACC
TATCATTGCCTAACCAAGT->ATCATTGCCTAACCAAGTT
ATCGAAGCTTTGATCTCGA->TCGAAGCTTTGATCTCGAG
CTGCACCTAACCTTGACCG->TGCACCTAACCTTGACCGC
TTGGCCCATCTAAATCCGG->TGGCCCATCTAAATCCGGA
TCCCGTAGCTATACCTCCA->CCCGTAGCTATACCTCCAT
CGCTATACGCTCAAGAAAG->GCTATACGCTCAAGAAAGG
GGCTTTGAGCCCTAGGGCA->GCTTTGAGCCCTAGGGCAA
CCGAGCACAGAGTCGTCCG->CGAGCACAGAGTCGTCCGG
ACATATACAACGCCAGCTG->CATATACAACGCCAGCTGA
TGCTTTACATCCTTCCGTT->GCTTTACATCCTTCCGTTA
TAGCGCACAAGAAATCCCC->AGCGCACAAGAAATCCCCT
AATCTGGACAGACCCCAGG->ATCTGGACAGACCCCAGGC
TACGATACAATAATCTGGA->ACGATACAATAATCTGGAC
GCACACTAAGTAGCCTATT->CACACTAAGTAGCCTATTC
ATTCCGGTTCTAAATATCC->TTCCGGTTCTAAATATCCA
TTTTTACTGAGGATACGCA->TTTTACTGAGGATACGCAA
GACAACCTCTGACCGATTC->ACAACCTCTGACCGATTCT
TTCGTATTTGCCGGGTAGT->TCGTATTTGCCGGGTAGTA
GACAGACCCCAGGCTATAA->ACAGACCCCAGGCTATAAA
GATTCATGCGCTAGCTCAA->ATTCATGCGCTAGCTCAAG
GCGCACAAGAAATCCCCTT->CGCACAAGAAATCCCCTTC
TATAAAAGTATCTGATTAG->ATAAAAGTATCTGATTAGA
GGGCCAGTAGTATACTGCA->GGCCAGTAGTATACTGCAC
AGATTCATGCGCTAGCTCA->GATTCATGCGCTAGCTCAA
TCATATTCTGCGGGGAGTT->CATATTCTGCGGGGAGTTC
TGTACATATACAACGCCAG->GTACATATACAACGCCAGC
CTAGGGCAAAGAGCGGAGT->TAGGGCAAAGAGCGGAGTA
CGTCCATCCGTGTGGTCGA->GTCCATCCGTGTGGTCGAA
GCCCATCTAAATCCGGAAA->CCCATCTAAATCCGGAAAA
CTCCTGCGAGCCTGCAGGA->TCCTGCGAGCCTGCAGGAA
TATAGAGTACCAAAGATGG->ATAGAGTACCAAAGATGGT
GGTGTCTGCTTGCACATTT->GTGTCTGCTTGCACATTTC
CCATCCGAGGAAGAGGTCA->CATCCGAGGAAGAGGTCAT
TTGCACACTAAGTAGCCTA->TGCACACTAAGTAGCCTAT
GGTAGAATTGTCTGGGTCC->GTAGAATTGTCTGGGTCCC
TGCGCTAGCTCAAGAAAGG->GCGCTAGCTCAAGAAAGGG
TATGATGCCGTTATAGAGT->ATGATGCCGTTATAGAGTA
CTAGCGCACAAGAAATCCC->TAGCGCACAAGAAATCCCC
CCTCTCTCGATTCCCGCAT->CTCTCTCGATTCCCGCATC
ACGCGACTGACATTAAGGG->CGCGACTGACATTAAGGGA
TAGACGCTAGTCCCCCAGT->AGACGCTAGTCCCCCAGTC
CCCCTTCCCTATTTTCCAC->CCCTTCCCTATTTTCCACC
CTTATATGTGTCTTACCTC->TTATATGTGTCTTACCTCA
CCTAGTCACTGCTTGGTGG->CTAGTCACTGCTTGGTGGT
GCACATTTCCTAGTCACTG->CACATTTCCTAGTCACTGC
CGCTAGTCCCCCAGTCAGT->GCTAGTCCCCCAGTCAGTG
GTCATATTCTGCGGGGAGT->TCATATTCTGCGGGGAGTT
CCTAGGGCAAAGAGCGGAG->CTAGGGCAAAGAGCGGAGT
AGTCGCAATCAGAATGTCG->GTCGCAATCAGAATGTCGG
CATTGCACACTAAGTAGCC->ATTGCACACTAAGTAGCCT
AGCCGAGTGTGGTGCAAGT->GCCGAGTGTGGTGCAAGTA
CAGCGGTTCCCGACCGTCT->AGCGGTTCCCGACCGTCTG
CACTCGGTAGTCCCCTCGT->ACTCGGTAGTCCCCTCGTT
GACTCAGATTGATATTCCC->ACTCAGATTGATATTCCCG
GTCATATCAGCTATGTCAC->TCATATCAGCTATGTCACA
TTATTGAAGTGGTAAAAGG->TATTGAAGTGGTAAAAGGA
TGAGCCCTAGGGCAAAGAG->GAGCCCTAGGGCAAAGAGC
GTCGTTAGGCTTCAGTATC->TCGTTAGGCTTCAGTATCT
AAATGCTGTCATATCAGCT->AATGCTGTCATATCAGCTA
ATCTGCCGGAATTTCCATG->TCTGCCGGAATTTCCATGT
AGTACGTAGACTTCGTATT->GTACGTAGACTTCGTATTT
TTTAAAAAGGCTTCTCGAT->TTAAAAAGGCTTCTCGATA
TGAGGAATCGTCCATCCGT->GAGGAATCGTCCATCCGTG
TCTGATTAGAGTCGCGAAA->CTGATTAGAGTCGCGAAAG
AGCCAGGTGTCTGCTTGCA->GCCAGGTGTCTGCTTGCAC
ATACCTCCATATGCTCAAG->TACCTCCATATGCTCAAGA
TATTGAGGAATCGTCCATC->ATTGAGGAATCGTCCATCC
GCTTTGAGCCCTAGGGCAA->CTTTGAGCCCTAGGGCAAA
AACAAGGTTTTAGTCCCTA->ACAAGGTTTTAGTCCCTAA
CTAGCTCAAGAAAGGGGCC->TAGCTCAAGAAAGGGGCCA
ATTATGCTCACCTCTTCAC->TTATGCTCACCTCTTCACG
GACTGACATTAAGGGACAA->ACTGACATTAAGGGACAAC
GAATAGCGTAACGCGTGTT->AATAGCGTAACGCGTGTTT
TAACCTAACCTTGACCGCC->AACCTAACCTTGACCGCCT
TTCAACTCTTGACCTCCGC->TCAACTCTTGACCTCCGCC
TTGACCGCCTCCCGTTTGG->TGACCGCCTCCCGTTTGGC
GGAGTATCGGTCATCGATA->GAGTATCGGTCATCGATAA
GGTCAATCTTTCCGCATTA->GTCAATCTTTCCGCATTAT
TTAACACTGGTATAGTTAT->TAACACTGGTATAGTTATT
ATTTCCTAGTCACTGCTTG->TTTCCTAGTCACTGCTTGG
CAACTCTTGACCTCCGCCA->AACTCTTGACCTCCGCCAA
AAGGCTCAAGAAAGGGGCC->AGGCTCAAGAAAGGGGCCA
GCAATCAGAATGTCGGCTC->CAATCAGAATGTCGGCTCG
TGCTTCTATGATGCCGTTA->GCTTCTATGATGCCGTTAT
AAGGATCTGTCACATCTCT->AGGATCTGTCACATCTCTG
CGGTTCCCGACCGTCTGGT->GGTTCCCGACCGTCTGGTA
CTCAAGAAAGGGGCCAGGC->TCAAGAAAGGGGCCAGGCA
AGTAGTATACTGCACCTAA->GTAGTATACTGCACCTAAC
GCATCTGCTCATGTCGCCA->CATCTGCTCATGTCGCCAG
CAGTGAACAACCAATACCG->AGTGAACAACCAATACCGC
CCGTCTGGTACCAACAACG->CGTCTGGTACCAACAACGG
TTCCGTTAACGGTCCGAGT->TCCGTTAACGGTCCGAGTC
AGCCATCATCAAAAGGAGT->GCCATCATCAAAAGGAGTG
CCCTCGTTTAAACCACATC->CCTCGTTTAAACCACATCT
CATCTAAATCCGGAAAAAC->ATCTAAATCCGGAAAAACA
TACATATACAACGCCAGCT->ACATATACAACGCCAGCTG
CCTAGTGAAGCTCATCGGA->CTAGTGAAGCTCATCGGAG
TCACCTCTTCACGCGACTG->CACCTCTTCACGCGACTGA
TAAAAATGTGCCTTGGACT->AAAAATGTGCCTTGGACTA
CAAGATTCCTTATCGAAGC->AAGATTCCTTATCGAAGCT
ATCTTTCCGCATTATGCTC->TCTTTCCGCATTATGCTCA
CTGATTAGAGTCGCGAAAG->TGATTAGAGTCGCGAAAGG
CCGAGTTCGCTATACGCTC->CGAGTTCGCTATACGCTCA
GGTCGGTGGCTATTAAGTC->GTCGGTGGCTATTAAGTCT
ATTACGACATAAGTCCTGC->TTACGACATAAGTCCTGCC
CGCAACTCCCGTAGCTATA->GCAACTCCCGTAGCTATAC
ACTCAGTTCTTCAACTCTT->CTCAGTTCTTCAACTCTTG
ACTTAAGTTAACTCTATAA->CTTAAGTTAACTCTATAAT
GACTCCCAGATCAGTCGCA->ACTCCCAGATCAGTCGCAA
AGGTGTCTGCTTGCACATT->GGTGTCTGCTTGCACATTT
TCTGGGTCCCGTAGCGGAC->CTGGGTCCCGTAGCGGACG
GAAATCATATTCACGCAAA->AAATCATATTCACGCAAAC
GGTAGGCGGGCCAATATAA->GTAGGCGGGCCAATATAAT
CTCTAAGTAATGAAAGCCG->TCTAAGTAATGAAAGCCGA
GTTCCCGACCGTCTGGTAC->TTCCCGACCGTCTGGTACC
TTGCTTCTATGATGCCGTT->TGCTTCTATGATGCCGTTA
GGATTCATACCGAAACATG->GATTCATACCGAAACATGG
TCCGAGGAAGAGGTCATCC->CCGAGGAAGAGGTCATCCC
CTGAGGATACGCAACTCCC->TGAGGATACGCAACTCCCG
GTTCTTCAACTCTTGACCT->TTCTTCAACTCTTGACCTC
GAAAGGGGCCAGTAGTATA->AAAGGGGCCAGTAGTATAC
GCCCTCTGCCGTTTTATTG->CCCTCTGCCGTTTTATTGA
CCGCTCAGTGAACAACCAA->CGCTCAGTGAACAACCAAT
GACCACGCGTCAGCTGTAT->ACCACGCGTCAGCTGTATT
CCAGTAGTATACTGCACCT->CAGTAGTATACTGCACCTA
TTGCTAGCCATCATCAAAA->TGCTAGCCATCATCAAAAG
TCCATCCGTGTGGTCGAAT->CCATCCGTGTGGTCGAATA
CTCGATTCCCGCATCTGCT->TCGATTCCCGCATCTGCTC
GAATTATGTTAGTACGTAG->AATTATGTTAGTACGTAGA
TGATTAGAGTCGCGAAAGG->GATTAGAGTCGCGAAAGGT
ATCCGAGCACAGAGTCGTC->TCCGAGCACAGAGTCGTCC
GTATAGTTATTGAGGAATC->TATAGTTATTGAGGAATCG
CGATACAATAATCTGGACA->GATACAATAATCTGGACAG
ACGCAACTCCCGTAGCTAT->CGCAACTCCCGTAGCTATA
ATCTCGAGGGTAGAATTGT->TCTCGAGGGTAGAATTGTC
GCTTGCACATTTCCTAGTC->CTTGCACATTTCCTAGTCA
TAGGAGCCCTCAGAGGATG->AGGAGCCCTCAGAGGATGA
ATCAAAAGGAGTGTAAAAA->TCAAAAGGAGTGTAAAAAT
CAGTATCTGCCGGAATTTC->AGTATCTGCCGGAATTTCC
CGTAGCTATACCTCCATAT->GTAGCTATACCTCCATATG
GCACAGAGTCGTCCGGGGG->CACAGAGTCGTCCGGGGGC
TAACCTTGACCGCCTCCTG->AACCTTGACCGCCTCCTGC
AAGAAAGGGGCCAGCCTTA->AGAAAGGGGCCAGCCTTAT
GTCGGCTCGAATTATGTTA->TCGGCTCGAATTATGTTAG
CCTGCGAGCCTGCAGGAAG->CTGCGAGCCTGCAGGAAGC
TATACGGGACTCCCAGATC->ATACGGGACTCCCAGATCA
ACGACATAAGTCCTGCCGC->CGACATAAGTCCTGCCGCA
CACATCAATAGTACATGGA->ACATCAATAGTACATGGAT
TCATTGCTCTTTGTGCAGC->CATTGCTCTTTGTGCAGCT
TACATCCTTCCGTTAACGG->ACATCCTTCCGTTAACGGT
AACTACATTGTATTGGCCC->ACTACATTGTATTGGCCCA
AAGTTGTACATATACAACG->AGTTGTACATATACAACGC
CGGGCTACTACGGGAAAGT->GGGCTACTACGGGAAAGTT
AACCAATACCGCCACCCTC->ACCAATACCGCCACCCTCG
CGACGTACGATACAATAAT->GACGTACGATACAATAATC
GTGTGGTGCAAGTACACCA->TGTGGTGCAAGTACACCAC
TCGGTAGTCCCCTCGTTTA->CGGTAGTCCCCTCGTTTAA
TTATCGAAGCTTTGATCTC->TATCGAAGCTTTGATCTCG
AAAAATGTGCCTTGGACTA->AAAATGTGCCTTGGACTAG
CGATTCTCGGCTTTGAGCC->GATTCTCGGCTTTGAGCCC
ATAATTAACACTGGTATAG->TAATTAACACTGGTATAGT
TTTACTTGTGCTTTACATC->TTACTTGTGCTTTACATCC
AAGCTCATCGGAGGCCAGT->AGCTCATCGGAGGCCAGTT
ACCCCAGGCTATAAAAGTA->CCCCAGGCTATAAAAGTAT
GTGCTTTACATCCTTCCGT->TGCTTTACATCCTTCCGTT
ACAAGTTGTACATATACAA->CAAGTTGTACATATACAAC
TGATGCCGTTATAGAGTAC->GATGCCGTTATAGAGTACC
GTGCAGCTTATATGTGTCT->TGCAGCTTATATGTGTCTT
ATCGGAGGCCAGTTGCTAG->TCGGAGGCCAGTTGCTAGC
CCCACATCAATAGTACATG->CCACATCAATAGTACATGG
CCCGTAGCGGACGCATCCG->CCGTAGCGGACGCATCCGA
TCGGTAGGCGGGCCAATAT->CGGTAGGCGGGCCAATATA
CTGGTATAGTTATTGAGGA->TGGTATAGTTATTGAGGAA
CGGAGTATCGGTCATCGAT->GGAGTATCGGTCATCGATA
GCTCTTTGTGCAGCTTATA->CTCTTTGTGCAGCTTATAT
GATTCATACCGAAACATGG->ATTCATACCGAAACATGGT
CTAATTGAACTCAGTTCTT->TAATTGAACTCAGTTCTTC
TTTCCTAGTCACTGCTTGG->TTCCTAGTCACTGCTTGGT
GCAGTTACGCCACTCTCCC->CAGTTACGCCACTCTCCCA
CGCAATCAGAATGTCGGCT->GCAATCAGAATGTCGGCTC
GACGTACGATACAATAATC->ACGTACGATACAATAATCT
CTGCAGGAAGCCAGGTGTC->TGCAGGAAGCCAGGTGTCT
CCACTTAAGTTAACTCTAT->CACTTAAGTTAACTCTATA
ATTTCTTGTTAATTGATTC->TTTCTTGTTAATTGATTCC
GCTCGACCACGCGTCAGCT->CTCGACCACGCGTCAGCTG
ACGGTCCGAGTCATATTCT->CGGTCCGAGTCATATTCTG
ATAGAGTACCAAAGATGGT->TAGAGTACCAAAGATGGTC
TCATTTCTTGTTAATTGAT->CATTTCTTGTTAATTGATT
CGCATCTGCTCATGTCGCC->GCATCTGCTCATGTCGCCA
GTAGACTTCGTATTTGCCG->TAGACTTCGTATTTGCCGG
ACGCCTGAAGGTAAGTCCG->CGCCTGAAGGTAAGTCCGA
GTCCTGCCGCATGAAGCGC->TCCTGCCGCATGAAGCGCA
ATTCACGCAAACCCAAATA->TTCACGCAAACCCAAATAA
TACTCTAAGTAATGAAAGC->ACTCTAAGTAATGAAAGCC
CCTAACCTTGACCGCCTCC->CTAACCTTGACCGCCTCCC,CTAACCTTGACCGCCTCCT
CGAGTGTGGTGCAAGTACA->GAGTGTGGTGCAAGTACAC
CTCAGAGGATGAAAGCCCT->TCAGAGGATGAAAGCCCTC
CCGAGTCATATTCTGCGGG->CGAGTCATATTCTGCGGGG
TCAAGAAAGGGGCCAGCCT->CAAGAAAGGGGCCAGCCTT
ATAGTTATTGAGGAATCGT->TAGTTATTGAGGAATCGTC
CACCCTCGCTCGACCACGC->ACCCTCGCTCGACCACGCG
ACGCAAACCCAAATAATTA->CGCAAACCCAAATAATTAA
GCTATTAAGTCTGTTCGCG->CTATTAAGTCTGTTCGCGC
ATCCACTTAAGTTAACTCT->TCCACTTAAGTTAACTCTA
GCATTATGCTCACCTCTTC->CATTATGCTCACCTCTTCA
TGTCACATATCTGTCGTTA->GTCACATATCTGTCGTTAG
AAGTTCCCTAACAAGGTTT->AGTTCCCTAACAAGGTTTT
GCTGTCATATCAGCTATGT->CTGTCATATCAGCTATGTC
ACACTGGTATAGTTATTGA->CACTGGTATAGTTATTGAG
TAGTCCCTAACTAACCGTT->AGTCCCTAACTAACCGTTA
GTTTCTGGCCTATACGGGA->TTTCTGGCCTATACGGGAC
CTTTCAACCTCGCCAGCGT->TTTCAACCTCGCCAGCGTT
ATGCCGTTATAGAGTACCA->TGCCGTTATAGAGTACCAA
GAGGATGAAAGCCCTCTGC->AGGATGAAAGCCCTCTGCC
TCCCTATTTTCCACCCCAT->CCCTATTTTCCACCCCATC
GACATTAAGGGACAACTAC->ACATTAAGGGACAACTACA
CTACTACGGGAAAGTTCCT->TACTACGGGAAAGTTCCTA
GCTATGTCACATATCTGTC->CTATGTCACATATCTGTCG
AGAAATCCCCTTCCCTATT->GAAATCCCCTTCCCTATTT
ACGCTAGTCCCCCAGTCAG->CGCTAGTCCCCCAGTCAGT
TCTTTCCGCATTATGCTCA->CTTTCCGCATTATGCTCAC
GTGTTTCGCTTATCATTGC->TGTTTCGCTTATCATTGCC
AGTGAACAACCAATACCGC->GTGAACAACCAATACCGCC
AATGACAACCTCTGACCGA->ATGACAACCTCTGACCGAT
GGAAAGTTCCTAGATTCAT->GAAAGTTCCTAGATTCATG
CTATTTTTACTGAGGATAC->TATTTTTACTGAGGATACG
CGCCTCCCGTTTGGCATGG->GCCTCCCGTTTGGCATGGT
ATCCCACATCAATAGTACA->TCCCACATCAATAGTACAT
CTAAGTAATGAAAGCCGAG->TAAGTAATGAAAGCCGAGT
GAAATCCCCTTCCCTATTT->AAATCCCCTTCCCTATTTT
GTCTGTTCGCGCGCTACCA->TCTGTTCGCGCGCTACCAA
ATTGTCTGGGTCCCGTAGC->TTGTCTGGGTCCCGTAGCG
TGACGGTGTGGAATGACAA->GACGGTGTGGAATGACAAC
GCCCTATCACCCCGGAAAG->CCCTATCACCCCGGAAAGA
AGCTGACGCGGATCCACCG->GCTGACGCGGATCCACCGC
CTCTGACCACTAGCGCACA->TCTGACCACTAGCGCACAA
AAGCGCAGTTACGCCACTC->AGCGCAGTTACGCCACTCT
TCACCCCGGAAAGACTCAG->CACCCCGGAAAGACTCAGA
ATACGGGACTCCCAGATCA->TACGGGACTCCCAGATCAG
ACATGGATTCATACCGAAA->CATGGATTCATACCGAAAC
GATAATCTACGCCTGAAGG->ATAATCTACGCCTGAAGGT
ACCGCGGTGCGGCAGTCGT->CCGCGGTGCGGCAGTCGTG
TGAAGCTCATCGGAGGCCA->GAAGCTCATCGGAGGCCAG
CGGATCCACCGCGGTGCGG->GGATCCACCGCGGTGCGGC
GAATGACAACCTCTGACCG->AATGACAACCTCTGACCGA
TCTGCCGGAATTTCCATGT->CTGCCGGAATTTCCATGTT
GTTCCTAGATTCATGCGCT->TTCCTAGATTCATGCGCTA
GGGGCCAGACGCCTCAATA->GGGCCAGACGCCTCAATAA
CTATACGCTCAAGAAAGGG->TATACGCTCAAGAAAGGGG
GAGTCGTCCGGGGGCAAGT->AGTCGTCCGGGGGCAAGTC
ATTTTTACTGAGGATACGC->TTTTTACTGAGGATACGCA
ATTAGAGTCGCGAAAGGTC->TTAGAGTCGCGAAAGGTCG
TGCACATTTCCTAGTCACT->GCACATTTCCTAGTCACTG
TCTAAGTAATGAAAGCCGA->CTAAGTAATGAAAGCCGAG
TCGACCACGCGTCAGCTGT->CGACCACGCGTCAGCTGTA
GTTTTAGTCCCTAACTAAC->TTTTAGTCCCTAACTAACC
GAAAGGTCGGTGGCTATTA->AAAGGTCGGTGGCTATTAA
TCCACCCCATCCGAGGAAG->CCACCCCATCCGAGGAAGA
CTGACGCGGATCCACCGCG->TGACGCGGATCCACCGCGG
GAATCGTCCATCCGTGTGG->AATCGTCCATCCGTGTGGT
CAGTAGTATACTGCACCTA->AGTAGTATACTGCACCTAA
AATTTCCATGTTCATTGCT->ATTTCCATGTTCATTGCTC
TCGATAATCTACGCCTGAA->CGATAATCTACGCCTGAAG
CATTATGCTCACCTCTTCA->ATTATGCTCACCTCTTCAC
ATGCTCACCTCTTCACGCG->TGCTCACCTCTTCACGCGA
CATATCTGTCGTTAGGCTT->ATATCTGTCGTTAGGCTTC
GCCAATATAATGGGCCAAT->CCAATATAATGGGCCAATA
TCTGTCGTTAGGCTTCAGT->CTGTCGTTAGGCTTCAGTA
GTCTGGTACCAACAACGGC->TCTGGTACCAACAACGGCC
CGAATAGACGCTAGTCCCC->GAATAGACGCTAGTCCCCC
GCTTTACATCCTTCCGTTA->CTTTACATCCTTCCGTTAA
GTCCCGGCAACCTAGTGAA->TCCCGGCAACCTAGTGAAG
TACATGGATTCATACCGAA->ACATGGATTCATACCGAAA
GTGTGGAATGACAACCTCT->TGTGGAATGACAACCTCTG
ACATCTCTGTGCTGGTTTC->CATCTCTGTGCTGGTTTCT
TGCTTGCACATTTCCTAGT->GCTTGCACATTTCCTAGTC
TCAGTGAACAACCAATACC->CAGTGAACAACCAATACCG
TCCCCTTCCCTATTTTCCA->CCCCTTCCCTATTTTCCAC
CGAGTTCGCTATACGCTCA->GAGTTCGCTATACGCTCAA
AGGGGCCAGTAGTATACTG->GGGGCCAGTAGTATACTGC
CTTACCTCAACTTTAGGCC->TTACCTCAACTTTAGGCCA
CTATACCTCCATATGCTCA->TATACCTCCATATGCTCAA
GTGAACAACCAATACCGCC->TGAACAACCAATACCGCCA
GAAAAACAAGTTGTACATA->AAAAACAAGTTGTACATAT
AACGGTCCGAGTCATATTC->ACGGTCCGAGTCATATTCT
ACTCTTGACCTCCGCCAAC->CTCTTGACCTCCGCCAACC
CATCAAAAGGAGTGTAAAA->ATCAAAAGGAGTGTAAAAA
TGAAGCGCAGTTACGCCAC->GAAGCGCAGTTACGCCACT
TTCAGTATCTGCCGGAATT->TCAGTATCTGCCGGAATTT
GTCCCCTCGTTTAAACCAC->TCCCCTCGTTTAAACCACA
ACTCAGATTGATATTCCCG->CTCAGATTGATATTCCCGT
TTCCCTATTTTCCACCCCA->TCCCTATTTTCCACCCCAT
AAAGATGGTCGGTAGGCGG->AAGATGGTCGGTAGGCGGG
CCGGTTCTAAATATCCACT->CGGTTCTAAATATCCACTT
TATCGAAGCTTTGATCTCG->ATCGAAGCTTTGATCTCGA
ACCTTGACCGCCTCCCGTT->CCTTGACCGCCTCCCGTTT
CGGGAAAGTTCCTAGATTC->GGGAAAGTTCCTAGATTCA
GCCGTTTTATTGAAGTGGT->CCGTTTTATTGAAGTGGTA
CCGACCGTCTGGTACCAAC->CGACCGTCTGGTACCAACA
CATTAAGGGACAACTACAT->ATTAAGGGACAACTACATT
GTTGTGGCGACGTACGATA->TTGTGGCGACGTACGATAC
ATATCTGTCGTTAGGCTTC->TATCTGTCGTTAGGCTTCA
CCTTGACCGCCTCGCTTGA->CTTGACCGCCTCGCTTGAA
TGCAGCTTATATGTGTCTT->GCAGCTTATATGTGTCTTA
GCGGGGAGTTCTGGTGTCC->CGGGGAGTTCTGGTGTCCC
TCACATCTCTGTGCTGGTT->CACATCTCTGTGCTGGTTT
CTTGACCGCCTCTGACCAC->TTGACCGCCTCTGACCACT
TTATGCTCACCTCTTCACG->TATGCTCACCTCTTCACGC
GCCTCCCGTTTGGCATGGT->CCTCCCGTTTGGCATGGTG
CTAGTGAAGCTCATCGGAG->TAGTGAAGCTCATCGGAGG
TGCACACTAAGTAGCCTAT->GCACACTAAGTAGCCTATT
CGAGGGTAGAATTGTCTGG->GAGGGTAGAATTGTCTGGG
AAACAAGTTGTACATATAC->AACAAGTTGTACATATACA
GCTTGGTGGTCGTCAGCGG->CTTGGTGGTCGTCAGCGGT
GAGTGTAAAAATGTGCCTT->AGTGTAAAAATGTGCCTTG
CATCCGAGCACAGAGTCGT->ATCCGAGCACAGAGTCGTC
TGGGCCAATAGGTTGAGTG->GGGCCAATAGGTTGAGTGA
CACTAGCGCACAAGAAATC->ACTAGCGCACAAGAAATCC
TCAGTCGCAATCAGAATGT->CAGTCGCAATCAGAATGTC
ATACGCAACTCCCGTAGCT->TACGCAACTCCCGTAGCTA
TATGTTAGTACGTAGACTT->ATGTTAGTACGTAGACTTC
CCAGCTGACGCGGATCCAC->CAGCTGACGCGGATCCACC
TAATCTACGCCTGAAGGTA->AATCTACGCCTGAAGGTAA
AGACTCAGATTGATATTCC->GACTCAGATTGATATTCCC
CCCCTCGTTTAAACCACAT->CCCTCGTTTAAACCACATC
GGATGGGTCTCGCTGTCTC->GATGGGTCTCGCTGTCTCG
CCACCCCATCCGAGGAAGA->CACCCCATCCGAGGAAGAG
CACCCCATCCGAGGAAGAG->ACCCCATCCGAGGAAGAGG
CACTTAAGTTAACTCTATA->ACTTAAGTTAACTCTATAA
GGCCAGTAGTATACTGCAC->GCCAGTAGTATACTGCACC
CGGTGCGGCAGTCGTGTCA->GGTGCGGCAGTCGTGTCAT
TCTTGACCTCCGCCAACCA->CTTGACCTCCGCCAACCAC
CCAGACGCCTCAATAACCT->CAGACGCCTCAATAACCTA
GCAGTCGTGTCATGGAATA->CAGTCGTGTCATGGAATAG
AACAAGTTGTACATATACA->ACAAGTTGTACATATACAA
TACGTAGACTTCGTATTTG->ACGTAGACTTCGTATTTGC
GATGCCGTTATAGAGTACC->ATGCCGTTATAGAGTACCA
ACATATGTTGCACTCGGTA->CATATGTTGCACTCGGTAG
GAGTTCGCTATACGCTCAA->AGTTCGCTATACGCTCAAG
TATGTTGCACTCGGTAGTC->ATGTTGCACTCGGTAGTCC
CGACCGTCTGGTACCAACA->GACCGTCTGGTACCAACAA
GTACATATACAACGCCAGC->TACATATACAACGCCAGCT
GTCACATATCTGTCGTTAG->TCACATATCTGTCGTTAGG
AGACGCTAGTCCCCCAGTC->GACGCTAGTCCCCCAGTCA
GTATACTGCACCTAACCTT->TATACTGCACCTAACCTTG
GAACTCAGTTCTTCAACTC->AACTCAGTTCTTCAACTCT
TAAGTAGCCTATTCCAGGT->AAGTAGCCTATTCCAGGTC
TTGAGGAATCGTCCATCCG->TGAGGAATCGTCCATCCGT
TCGCGCCCAGGGTCCTCTC->CGCGCCCAGGGTCCTCTCT
CCATGTTCATTGCTCTTTG->CATGTTCATTGCTCTTTGT
GAAAGCCGAGTGTGGTGCA->AAAGCCGAGTGTGGTGCAA
TATGTCACATATCTGTCGT->ATGTCACATATCTGTCGTT
AAGGATGGGTCTCGCTGTC->AGGATGGGTCTCGCTGTCT
CTTCCCTATTTTCCACCCC->TTCCCTATTTTCCACCCCA
GATTCTCGGCTTTGAGCCC->ATTCTCGGCTTTGAGCCCT
TCTGGCCTATACGGGACTC->CTGGCCTATACGGGACTCC
TAGCGTAACGCGTGTTTCG->AGCGTAACGCGTGTTTCGC
TTTGATCTCGAGGGTAGAA->TTGATCTCGAGGGTAGAAT
GAGGAATCGTCCATCCGTG->AGGAATCGTCCATCCGTGT
AGGCTTCTCGATAATCTAC->GGCTTCTCGATAATCTACG
AGTTCCTAGATTCATGCGC->GTTCCTAGATTCATGCGCT
ATAATCTGGACAGACCCCA->TAATCTGGACAGACCCCAG
CATCTGTTCGCCAATTGGC->ATCTGTTCGCCAATTGGCG
GTCATCGATAAATGCTGTC->TCATCGATAAATGCTGTCA
TGACCGCCTCCTGCGAGCC->GACCGCCTCCTGCGAGCCT
TACCAAAGATGGTCGGTAG->ACCAAAGATGGTCGGTAGG
TCCCGCATCTGCTCATGTC->CCCGCATCTGCTCATGTCG
ACGGCCTTGCTTCTATGAT->CGGCCTTGCTTCTATGATG
GACCCCAGGCTATAAAAGT->ACCCCAGGCTATAAAAGTA
CAGGTCAATCTTTCCGCAT->AGGTCAATCTTTCCGCATT
CTAGTCACTGCTTGGTGGT->TAGTCACTGCTTGGTGGTC
TAGCGGACGCATCCGAGCA->AGCGGACGCATCCGAGCAC
CGGTCGCGCCCAGGGTCCT->GGTCGCGCCCAGGGTCCTC
ATTGGCGGTCGCGCCCAGG->TTGGCGGTCGCGCCCAGGG
CGGAATTTCCATGTTCATT->GGAATTTCCATGTTCATTG
CGTTAACGGTCCGAGTCAT->GTTAACGGTCCGAGTCATA
TCTCGAGGGTAGAATTGTC->CTCGAGGGTAGAATTGTCT
CTCATGTCGCCAGCGACAG->TCATGTCGCCAGCGACAGT
TGCGAGCCTGCAGGAAGCC->GCGAGCCTGCAGGAAGCCA
TTCCGGTTCTAAATATCCA->TCCGGTTCTAAATATCCAC
TCACGCGACTGACATTAAG->CACGCGACTGACATTAAGG
GTCGCAATCAGAATGTCGG->TCGCAATCAGAATGTCGGC
TGATATTCCCGTTACGGAA->GATATTCCCGTTACGGAAG
AAGTAGCCTATTCCAGGTC->AGTAGCCTATTCCAGGTCA
CCGCCACCCTCGCTCGACC->CGCCACCCTCGCTCGACCA
GCCGTTATAGAGTACCAAA->CCGTTATAGAGTACCAAAG
TCTTTGTGCAGCTTATATG->CTTTGTGCAGCTTATATGT
GTAGCTATACCTCCATATG->TAGCTATACCTCCATATGC
TTCAGACTACTCTAAGTAA->TCAGACTACTCTAAGTAAT
CGGAGGCCAGTTGCTAGCC->GGAGGCCAGTTGCTAGCCA
TACGGGACTCCCAGATCAG->ACGGGACTCCCAGATCAGT
GATCTCGAGGGTAGAATTG->ATCTCGAGGGTAGAATTGT
CATATCAGCTATGTCACAT->ATATCAGCTATGTCACATA
CTCAAGAAAGGGGCCAGAC->TCAAGAAAGGGGCCAGACG
CTTGACCGCCTCCCGTTTG->TTGACCGCCTCCCGTTTGG
TGCCGTTATAGAGTACCAA->GCCGTTATAGAGTACCAAA
TACCGCCACCCTCGCTCGA->ACCGCCACCCTCGCTCGAC
AACCTCTGACCGATTCTCG->ACCTCTGACCGATTCTCGG
TACGGGAAAGTTCCTAGAT->ACGGGAAAGTTCCTAGATT
ATAACCTAACCTTGACCGC->TAACCTAACCTTGACCGCC
TTCCCGACCGTCTGGTACC->TCCCGACCGTCTGGTACCA
GGTCGAATAGACGCTAGTC->GTCGAATAGACGCTAGTCC
TGCCGGGTAGTAAATCTAA->GCCGGGTAGTAAATCTAAT
TTGTATTGGCCCATCTAAA->TGTATTGGCCCATCTAAAT
CAAGTCATCGTACATTGCA->AAGTCATCGTACATTGCAC
GTCCATCCGTGTGGTCGAA->TCCATCCGTGTGGTCGAAT
GTTCCGGGCTACTACGGGA->TTCCGGGCTACTACGGGAA
CAAAGAGCGGAGTATCGGT->AAAGAGCGGAGTATCGGTC
CTCCGCTCAGTGAACAACC->TCCGCTCAGTGAACAACCA
TTAAACCACATCTGTTCGC->TAAACCACATCTGTTCGCC
AAGGGGCCAGTAGTATACT->AGGGGCCAGTAGTATACTG
TGCGGGGAGTTCTGGTGTC->GCGGGGAGTTCTGGTGTCC
TATCTGCCGGAATTTCCAT->ATCTGCCGGAATTTCCATG
GGAATCGTCCATCCGTGTG->GAATCGTCCATCCGTGTGG
CTCTATAATCTCCGCTCAG->TCTATAATCTCCGCTCAGT
CTGCTTGCACATTTCCTAG->TGCTTGCACATTTCCTAGT
GTTCATTTCTTGTTAATTG->TTCATTTCTTGTTAATTGA
GTGAAGCTCATCGGAGGCC->TGAAGCTCATCGGAGGCCA
TGAAAGCCGAGTGTGGTGC->GAAAGCCGAGTGTGGTGCA
AAAGCCGAGTGTGGTGCAA->AAGCCGAGTGTGGTGCAAG
CTCGATAATCTACGCCTGA->TCGATAATCTACGCCTGAA
GCTTTGATCTCGAGGGTAG->CTTTGATCTCGAGGGTAGA
ACCAAGCTAGCCCTATCAC->CCAAGCTAGCCCTATCACC
TTTCCACCCCATCCGAGGA->TTCCACCCCATCCGAGGAA
GTCAATCTTTCCGCATTAT->TCAATCTTTCCGCATTATG
AGCGCTAAAAGGCTCAAGA->GCGCTAAAAGGCTCAAGAA
GAGCGGAGTATCGGTCATC->AGCGGAGTATCGGTCATCG
TATACAACGCCAGCTGACG->ATACAACGCCAGCTGACGC
TCTATGATGCCGTTATAGA->CTATGATGCCGTTATAGAG
GTTGAGTGACGGTGTGGAA->TTGAGTGACGGTGTGGAAT
TGGGTCCCGTAGCGGACGC->GGGTCCCGTAGCGGACGCA
TTGGCGGTCGCGCCCAGGG->TGGCGGTCGCGCCCAGGGT
GTGTCCCGGCAACCTAGTG->TGTCCCGGCAACCTAGTGA
GCTAGCCATCATCAAAAGG->CTAGCCATCATCAAAAGGA
AACCTTGACCGCCTCTGAC->ACCTTGACCGCCTCTGACC
CTTCAGTATCTGCCGGAAT->TTCAGTATCTGCCGGAATT
AAGCCAGGTGTCTGCTTGC->AGCCAGGTGTCTGCTTGCA
GCTTGAAGAAATCATATTC->CTTGAAGAAATCATATTCA
GGCAGTAAGCGGACCTAAC->GCAGTAAGCGGACCTAACC
GGGACAACTACATTGTATT->GGACAACTACATTGTATTG
CGTTACGGAAGGATCTGTC->GTTACGGAAGGATCTGTCA
GCCAGCCTTATGCAAGACC->CCAGCCTTATGCAAGACCT
CAATAATCTGGACAGACCC->AATAATCTGGACAGACCCC
TGTTCGCCAATTGGCGGTC->GTTCGCCAATTGGCGGTCG
CCATATGCTCAAGAAAGGG->CATATGCTCAAGAAAGGGG
AGCGCAGTTACGCCACTCT->GCGCAGTTACGCCACTCTC
ACCAAAGATGGTCGGTAGG->CCAAAGATGGTCGGTAGGC
CTCGGCTTTGAGCCCTAGG->TCGGCTTTGAGCCCTAGGG
AGCTGTATTCACCCTCATC->GCTGTATTCACCCTCATCG
ACGCGTCAGCTGTATTCAC->CGCGTCAGCTGTATTCACC
ATATATTATTACGACATAA->TATATTATTACGACATAAG
TAATTTCAGACTACTCTAA->AATTTCAGACTACTCTAAG
AGAGGTCATCCCACATCAA->GAGGTCATCCCACATCAAT
TACCAACAACGGCCTTGCT->ACCAACAACGGCCTTGCTT
CTTGGTGGTCGTCAGCGGT->TTGGTGGTCGTCAGCGGTT
ACTAACCGTTATCTTTCAA->CTAACCGTTATCTTTCAAC
CCGCATTATGCTCACCTCT->CGCATTATGCTCACCTCTT
CCACTCTCCCACTATTTTT->CACTCTCCCACTATTTTTA
CCTCGCTCGACCACGCGTC->CTCGCTCGACCACGCGTCA
GTAGCGGACGCATCCGAGC->TAGCGGACGCATCCGAGCA
CTTATCGAAGCTTTGATCT->TTATCGAAGCTTTGATCTC
GAGTGTGGTGCAAGTACAC->AGTGTGGTGCAAGTACACC
TTCGCGCGCTACCAAGCTA->TCGCGCGCTACCAAGCTAG
CCTTATCGAAGCTTTGATC->CTTATCGAAGCTTTGATCT
TGAGTGACGGTGTGGAATG->GAGTGACGGTGTGGAATGA
CGATAATCTACGCCTGAAG->GATAATCTACGCCTGAAGG
CAGTTTACTTGTGCTTTAC->AGTTTACTTGTGCTTTACA
ACTGACATTAAGGGACAAC->CTGACATTAAGGGACAACT
TATTCCAGGTCAATCTTTC->ATTCCAGGTCAATCTTTCC
TGGCGACGTACGATACAAT->GGCGACGTACGATACAATA
GCTCAAGAAAGGGGCCAGG->CTCAAGAAAGGGGCCAGGC
CGGAAGGATCTGTCACATC->GGAAGGATCTGTCACATCT
AGGCTCAAGAAAGGGGCCA->GGCTCAAGAAAGGGGCCAG
AAGTACACCACCCAGCAAG->AGTACACCACCCAGCAAGT
ACAGTTTACTTGTGCTTTA->CAGTTTACTTGTGCTTTAC
AGAGCGGAGTATCGGTCAT->GAGCGGAGTATCGGTCATC
TCAATCTTTCCGCATTATG->CAATCTTTCCGCATTATGC
ACCAACAACGGCCTTGCTT->CCAACAACGGCCTTGCTTC
ACATTTCCTAGTCACTGCT->CATTTCCTAGTCACTGCTT
TAATGGGCCAATAGGTTGA->AATGGGCCAATAGGTTGAG
CTAGATTCATGCGCTAGCT->TAGATTCATGCGCTAGCTC
TTAATTGATTCCGGTTCTA->TAATTGATTCCGGTTCTAA
TTAACTCTATAATCTCCGC->TAACTCTATAATCTCCGCT
TATGCTCACCTCTTCACGC->ATGCTCACCTCTTCACGCG
GCGGTGCGGCAGTCGTGTC->CGGTGCGGCAGTCGTGTCA
ATGTTAGTACGTAGACTTC->TGTTAGTACGTAGACTTCG
TAATTGAACTCAGTTCTTC->AATTGAACTCAGTTCTTCA
TGTTGCACTCGGTAGTCCC->GTTGCACTCGGTAGTCCCC
CTCACCTCTTCACGCGACT->TCACCTCTTCACGCGACTG
ATATAATGGGCCAATAGGT->TATAATGGGCCAATAGGTT
CTGCGGGGAGTTCTGGTGT->TGCGGGGAGTTCTGGTGTC
CCACTAGCGCACAAGAAAT->CACTAGCGCACAAGAAATC
CAGGCAGTAAGCGGACCTA->AGGCAGTAAGCGGACCTAA
TCATGGAATAGCGTAACGC->CATGGAATAGCGTAACGCG
CCGGGTAGTAAATCTAATT->CGGGTAGTAAATCTAATTG
TGCTTGGTGGTCGTCAGCG->GCTTGGTGGTCGTCAGCGG
CGGTAGTCCCCTCGTTTAA->GGTAGTCCCCTCGTTTAAA
TAGCCATCATCAAAAGGAG->AGCCATCATCAAAAGGAGT
AGTCCGAGTTCGCTATACG->GTCCGAGTTCGCTATACGC
CCTCTGACCACTAGCGCAC->CTCTGACCACTAGCGCACA
TTTGCCGGGTAGTAAATCT->TTGCCGGGTAGTAAATCTA
CCTGCAGGAAGCCAGGTGT->CTGCAGGAAGCCAGGTGTC
TTCGCTATACGCTCAAGAA->TCGCTATACGCTCAAGAAA
ATGTTCATTGCTCTTTGTG->TGTTCATTGCTCTTTGTGC
ACAGAGTCGTCCGGGGGCA->CAGAGTCGTCCGGGGGCAA
AGAGGATGAAAGCCCTCTG->GAGGATGAAAGCCCTCTGC
GATTCCTTATCGAAGCTTT->ATTCCTTATCGAAGCTTTG
GTCACTGCTTGGTGGTCGT->TCACTGCTTGGTGGTCGTC
TGCTCATGTCGCCAGCGAC->GCTCATGTCGCCAGCGACA
TCTTTCAACCTCGCCAGCG->CTTTCAACCTCGCCAGCGT
CGACAGTTTACTTGTGCTT->GACAGTTTACTTGTGCTTT
GGAGTGTAAAAATGTGCCT->GAGTGTAAAAATGTGCCTT
TAAATCTAATTGAACTCAG->AAATCTAATTGAACTCAGT
GGGTCCCGTAGCGGACGCA->GGTCCCGTAGCGGACGCAT
GTACGTAGACTTCGTATTT->TACGTAGACTTCGTATTTG
TAACCTTGACCGCCTCGCT->AACCTTGACCGCCTCGCTT
GTAGTCCCCTCGTTTAAAC->TAGTCCCCTCGTTTAAACC
TAAAAGGATGGGTCTCGCT->AAAAGGATGGGTCTCGCTG
GGATCTGTCACATCTCTGT->GATCTGTCACATCTCTGTG
GTAAGTCCGAGTTCGCTAT->TAAGTCCGAGTTCGCTATA
TCATACCGAAACATGGTTC->CATACCGAAACATGGTTCC
AAGTTGTGGCGACGTACGA->AGTTGTGGCGACGTACGAT
ATAAATGCTGTCATATCAG->TAAATGCTGTCATATCAGC
CGGGGAGTTCTGGTGTCCC->GGGGAGTTCTGGTGTCCCG
TCACTGCTTGGTGGTCGTC->CACTGCTTGGTGGTCGTCA
AATAATTAACACTGGTATA->ATAATTAACACTGGTATAG
TCATCGGAGGCCAGTTGCT->CATCGGAGGCCAGTTGCTA
TTATATGTGTCTTACCTCA->TATATGTGTCTTACCTCAA
AGTGGTAAAAGGATGGGTC->GTGGTAAAAGGATGGGTCT
TACTGAGGATACGCAACTC->ACTGAGGATACGCAACTCC
CCGAGTGTGGTGCAAGTAC->CGAGTGTGGTGCAAGTACA
ATACAATAATCTGGACAGA->TACAATAATCTGGACAGAC
TCCTGCGAGCCTGCAGGAA->CCTGCGAGCCTGCAGGAAG
CGAGCACAGAGTCGTCCGG->GAGCACAGAGTCGTCCGGG
AAGTCATCGTACATTGCAC->AGTCATCGTACATTGCACA
TTCACGCGACTGACATTAA->TCACGCGACTGACATTAAG
ATCTGTTCGCCAATTGGCG->TCTGTTCGCCAATTGGCGG
TTTGAGCCCTAGGGCAAAG->TTGAGCCCTAGGGCAAAGA
TCAACTTTAGGCCAAGATT->CAACTTTAGGCCAAGATTC
TAGAGTACCAAAGATGGTC->AGAGTACCAAAGATGGTCG
TCAATAGTACATGGATTCA->CAATAGTACATGGATTCAT
TATAATGGGCCAATAGGTT->ATAATGGGCCAATAGGTTG
AGGAATCGTCCATCCGTGT->GGAATCGTCCATCCGTGTG
AACCGTTATCTTTCAACCT->ACCGTTATCTTTCAACCTC
CTCGAGGGTAGAATTGTCT->TCGAGGGTAGAATTGTCTG
CACCACCCAGCAAGTTCCC->ACCACCCAGCAAGTTCCCT
CGGGACTCCCAGATCAGTC->GGGACTCCCAGATCAGTCG
CCAATATAATGGGCCAATA->CAATATAATGGGCCAATAG
TAGAATTGTCTGGGTCCCG->AGAATTGTCTGGGTCCCGT
TGACCTCCGCCAACCACAT->GACCTCCGCCAACCACATA
TCCTTATCGAAGCTTTGAT->CCTTATCGAAGCTTTGATC
AGAGTCGCGAAAGGTCGGT->GAGTCGCGAAAGGTCGGTG
CGTTTAAACCACATCTGTT->GTTTAAACCACATCTGTTC
CGGTGGCTATTAAGTCTGT->GGTGGCTATTAAGTCTGTT
GCCTCCTGCGAGCCTGCAG->CCTCCTGCGAGCCTGCAGG
CAATTGGCGGTCGCGCCCA->AATTGGCGGTCGCGCCCAG
TGCCTTGGACTAGCGCTAA->GCCTTGGACTAGCGCTAAA
ATCTGTCACATCTCTGTGC->TCTGTCACATCTCTGTGCT
CGTATTTGCCGGGTAGTAA->GTATTTGCCGGGTAGTAAA
GTTCGCCAATTGGCGGTCG->TTCGCCAATTGGCGGTCGC
AAAATGTGCCTTGGACTAG->AAATGTGCCTTGGACTAGC
AGTTCCCTAACAAGGTTTT->GTTCCCTAACAAGGTTTTA
CCGCCTCTGACCACTAGCG->CGCCTCTGACCACTAGCGC
GCCTCTGACCACTAGCGCA->CCTCTGACCACTAGCGCAC
GTTTAAACCACATCTGTTC->TTTAAACCACATCTGTTCG
AATGTCGGCTCGAATTATG->ATGTCGGCTCGAATTATGT
CGGTAGGCGGGCCAATATA->GGTAGGCGGGCCAATATAA
AGCGGACGCATCCGAGCAC->GCGGACGCATCCGAGCACA
GCTTCTCGATAATCTACGC->CTTCTCGATAATCTACGCC
TGCAAGTACACCACCCAGC->GCAAGTACACCACCCAGCA
AATATAATGGGCCAATAGG->ATATAATGGGCCAATAGGT
GTGGCGACGTACGATACAA->TGGCGACGTACGATACAAT
GGCGGGCCAATATAATGGG->GCGGGCCAATATAATGGGC
GGTGTATATATTATTACGA->GTGTATATATTATTACGAC
GTATTGGCCCATCTAAATC->TATTGGCCCATCTAAATCC
GGTCGTCAGCGGTTCCCGA->GTCGTCAGCGGTTCCCGAC
TAACCGTTATCTTTCAACC->AACCGTTATCTTTCAACCT
GAATTTCCATGTTCATTGC->AATTTCCATGTTCATTGCT
AGCTTTGATCTCGAGGGTA->GCTTTGATCTCGAGGGTAG
GTAAAAGGATGGGTCTCGC->TAAAAGGATGGGTCTCGCT
TACATTGTATTGGCCCATC->ACATTGTATTGGCCCATCT
GATCTGTCACATCTCTGTG->ATCTGTCACATCTCTGTGC
CTCGCTTGAAGAAATCATA->TCGCTTGAAGAAATCATAT
AAGATTCCTTATCGAAGCT->AGATTCCTTATCGAAGCTT
TAACGCGTGTTTCGCTTAT->AACGCGTGTTTCGCTTATC
GTTTTATTGAAGTGGTAAA->TTTTATTGAAGTGGTAAAA
CACGCGACTGACATTAAGG->ACGCGACTGACATTAAGGG
TCTGCGGGGAGTTCTGGTG->CTGCGGGGAGTTCTGGTGT
CATGGAATAGCGTAACGCG->ATGGAATAGCGTAACGCGT
ACGGTGTGGAATGACAACC->CGGTGTGGAATGACAACCT
GCATGAAGCGCAGTTACGC->CATGAAGCGCAGTTACGCC
TCGCCAATTGGCGGTCGCG->CGCCAATTGGCGGTCGCGC
GGCTAATTTCAGACTACTC->GCTAATTTCAGACTACTCT
AATGTGCCTTGGACTAGCG->ATGTGCCTTGGACTAGCGC
CGTGTTTCGCTTATCATTG->GTGTTTCGCTTATCATTGC
GCTAAAAGGCTCAAGAAAG->CTAAAAGGCTCAAGAAAGG
CCAAATAATTAACACTGGT->CAAATAATTAACACTGGTA
GTCGGTAGGCGGGCCAATA->TCGGTAGGCGGGCCAATAT
TCATCGATAAATGCTGTCA->CATCGATAAATGCTGTCAT
CACCTAACCTTGACCGCCT->ACCTAACCTTGACCGCCTC
AAGCTAGCCCTATCACCCC->AGCTAGCCCTATCACCCCG
ATTCACCCTCATCGGGTAG->TTCACCCTCATCGGGTAGG
GACAGTTTACTTGTGCTTT->ACAGTTTACTTGTGCTTTA
TCTCTGTGCTGGTTTCTGG->CTCTGTGCTGGTTTCTGGC
CATAAGTCCTGCCGCATGA->ATAAGTCCTGCCGCATGAA
TATTCCCGTTACGGAAGGA->ATTCCCGTTACGGAAGGAT
ATGTCGGCTCGAATTATGT->TGTCGGCTCGAATTATGTT
CACACTAAGTAGCCTATTC->ACACTAAGTAGCCTATTCC
TAGAGTCGCGAAAGGTCGG->AGAGTCGCGAAAGGTCGGT
AGCTAGCCCTATCACCCCG->GCTAGCCCTATCACCCCGG
AAAGGGGCCAGTAGTATAC->AAGGGGCCAGTAGTATACT
GCGTAACGCGTGTTTCGCT->CGTAACGCGTGTTTCGCTT
GGTGGTCGTCAGCGGTTCC->GTGGTCGTCAGCGGTTCCC
GCCAATAGGTTGAGTGACG->CCAATAGGTTGAGTGACGG
CTGTCGTTAGGCTTCAGTA->TGTCGTTAGGCTTCAGTAT
TATTATTACGACATAAGTC->ATTATTACGACATAAGTCC
CTATACGGGACTCCCAGAT->TATACGGGACTCCCAGATC
GGAGCCCTCAGAGGATGAA->GAGCCCTCAGAGGATGAAA
GCTATACGCTCAAGAAAGG->CTATACGCTCAAGAAAGGG
CATATGCTCAAGAAAGGGG->ATATGCTCAAGAAAGGGGC
CACATCTGTTCGCCAATTG->ACATCTGTTCGCCAATTGG
ACTTGTGCTTTACATCCTT->CTTGTGCTTTACATCCTTC
TACGCAACTCCCGTAGCTA->ACGCAACTCCCGTAGCTAT
TGTGGTCGAATAGACGCTA->GTGGTCGAATAGACGCTAG
TCGTGTCATGGAATAGCGT->CGTGTCATGGAATAGCGTA
GTCTGGGTCCCGTAGCGGA->TCTGGGTCCCGTAGCGGAC
GAGCCCTCAGAGGATGAAA->AGCCCTCAGAGGATGAAAG
ATACGCTCAAGAAAGGGGC->TACGCTCAAGAAAGGGGCC
TGGACTAGCGCTAAAAGGC->GGACTAGCGCTAAAAGGCT
GTCTTACCTCAACTTTAGG->TCTTACCTCAACTTTAGGC
CCACCCTCGCTCGACCACG->CACCCTCGCTCGACCACGC
CTCTCGATTCCCGCATCTG->TCTCGATTCCCGCATCTGC
CGCTTATCATTGCCTAACC->GCTTATCATTGCCTAACCA
CAAGTACACCACCCAGCAA->AAGTACACCACCCAGCAAG
GCAAGACCTAACCTTGACC->CAAGACCTAACCTTGACCG
CAGTTACGCCACTCTCCCA->AGTTACGCCACTCTCCCAC
TTAAGTCTGTTCGCGCGCT->TAAGTCTGTTCGCGCGCTA
AGCGGACCTAACCTTGACC->GCGGACCTAACCTTGACCG
CAATCTTTCCGCATTATGC->AATCTTTCCGCATTATGCT
CTAGCCCTATCACCCCGGA->TAGCCCTATCACCCCGGAA
TCATGTCGCCAGCGACAGT->CATGTCGCCAGCGACAGTT
CACCCCGGAAAGACTCAGA->ACCCCGGAAAGACTCAGAT
CCCCGGAAAGACTCAGATT->CCCGGAAAGACTCAGATTG
CTAAATATCCACTTAAGTT->TAAATATCCACTTAAGTTA
GTTCCCTAACAAGGTTTTA->TTCCCTAACAAGGTTTTAG
AGGCCAGTTGCTAGCCATC->GGCCAGTTGCTAGCCATCA
GCGTTTAAAAAGGCTTCTC->CGTTTAAAAAGGCTTCTCG
ACATGGTTCCGGGCTACTA->CATGGTTCCGGGCTACTAC
CGCTAGCTCAAGAAAGGGG->GCTAGCTCAAGAAAGGGGC
CCATCTAAATCCGGAAAAA->CATCTAAATCCGGAAAAAC
ACCCCATCCGAGGAAGAGG->CCCCATCCGAGGAAGAGGT
TAGTATACTGCACCTAACC->AGTATACTGCACCTAACCT
CAAAGATGGTCGGTAGGCG->AAAGATGGTCGGTAGGCGG
CGGTTCTAAATATCCACTT->GGTTCTAAATATCCACTTA
TGTCGTTAGGCTTCAGTAT->GTCGTTAGGCTTCAGTATC
CCCTCAGAGGATGAAAGCC->CCTCAGAGGATGAAAGCCC
CCTGCCGCATGAAGCGCAG->CTGCCGCATGAAGCGCAGT
GATACAATAATCTGGACAG->ATACAATAATCTGGACAGA
GTAGAATTGTCTGGGTCCC->TAGAATTGTCTGGGTCCCG
ATCTGATTAGAGTCGCGAA->TCTGATTAGAGTCGCGAAA
CAAACCCAAATAATTAACA->AAACCCAAATAATTAACAC
CAGACGCCTCAATAACCTA->AGACGCCTCAATAACCTAA
CCTCATCGGGTAGGAGCCC->CTCATCGGGTAGGAGCCCT
AAGAAATCCCCTTCCCTAT->AGAAATCCCCTTCCCTATT
CGCATCCGAGCACAGAGTC->GCATCCGAGCACAGAGTCG
AGTTTACTTGTGCTTTACA->GTTTACTTGTGCTTTACAT
TAGTACATGGATTCATACC->AGTACATGGATTCATACCG
AAGGCTTCTCGATAATCTA->AGGCTTCTCGATAATCTAC
CTATTCCAGGTCAATCTTT->TATTCCAGGTCAATCTTTC
GTATCTGATTAGAGTCGCG->TATCTGATTAGAGTCGCGA
GGTTCTAAATATCCACTTA->GTTCTAAATATCCACTTAA
CTCTCCCACTATTTTTACT->TCTCCCACTATTTTTACTG
CACATTTCCTAGTCACTGC->ACATTTCCTAGTCACTGCT
TTATCATTGCCTAACCAAG->TATCATTGCCTAACCAAGT
AGTGTGGTGCAAGTACACC->GTGTGGTGCAAGTACACCA
CTGCCGGAATTTCCATGTT->TGCCGGAATTTCCATGTTC
ACATTGTATTGGCCCATCT->CATTGTATTGGCCCATCTA
GCGCTAGCTCAAGAAAGGG->CGCTAGCTCAAGAAAGGGG
AAACCCAAATAATTAACAC->AACCCAAATAATTAACACT
TCCTAGTCACTGCTTGGTG->CCTAGTCACTGCTTGGTGG
TTATCTTTCAACCTCGCCA->TATCTTTCAACCTCGCCAG
AGTCATATTCTGCGGGGAG->GTCATATTCTGCGGGGAGT
GTATTTGCCGGGTAGTAAA->TATTTGCCGGGTAGTAAAT
CAATAGGTTGAGTGACGGT->AATAGGTTGAGTGACGGTG
CCACGCGTCAGCTGTATTC->CACGCGTCAGCTGTATTCA
GTACATGGATTCATACCGA->TACATGGATTCATACCGAA
CAGAATGTCGGCTCGAATT->AGAATGTCGGCTCGAATTA
TTCGCCAATTGGCGGTCGC->TCGCCAATTGGCGGTCGCG
ATACCGCCACCCTCGCTCG->TACCGCCACCCTCGCTCGA
TGTTCATTGCTCTTTGTGC->GTTCATTGCTCTTTGTGCA
TTGACCGCCTCCTGCGAGC->TGACCGCCTCCTGCGAGCC
CCTATTTTCCACCCCATCC->CTATTTTCCACCCCATCCG
ACGATACAATAATCTGGAC->CGATACAATAATCTGGACA
CTAACCTTGACCGCCTCTG->TAACCTTGACCGCCTCTGA
CTCGTTTAAACCACATCTG->TCGTTTAAACCACATCTGT
CTAGCGCTAAAAGGCTCAA->TAGCGCTAAAAGGCTCAAG
GGTAAAAGGATGGGTCTCG->GTAAAAGGATGGGTCTCGC
TGGCTATTAAGTCTGTTCG->GGCTATTAAGTCTGTTCGC
CTGGCCTATACGGGACTCC->TGGCCTATACGGGACTCCC
AGTTAACTCTATAATCTCC->GTTAACTCTATAATCTCCG
GATCCACCGCGGTGCGGCA->ATCCACCGCGGTGCGGCAG
GTTATCTTTCAACCTCGCC->TTATCTTTCAACCTCGCCA
AGCTCAAGAAAGGGGCCAG->GCTCAAGAAAGGGGCCAGA
CCTAACCTTGACCGCCTCG->CTAACCTTGACCGCCTCGC
CTCCCACTATTTTTACTGA->TCCCACTATTTTTACTGAG
TCATATTCACGCAAACCCA->CATATTCACGCAAACCCAA
CACTCTCCCACTATTTTTA->ACTCTCCCACTATTTTTAC
TTCCTAGATTCATGCGCTA->TCCTAGATTCATGCGCTAG
GGATGAAAGCCCTCTGCCG->GATGAAAGCCCTCTGCCGT
ACTCCCGTAGCTATACCTC->CTCCCGTAGCTATACCTCC
GTGTTCATTTCTTGTTAAT->TGTTCATTTCTTGTTAATT
AAAAGTATCTGATTAGAGT->AAAGTATCTGATTAGAGTC
CGCTCGACCACGCGTCAGC->GCTCGACCACGCGTCAGCT
GACCTCCGCCAACCACATA->ACCTCCGCCAACCACATAT
GGCTACTACGGGAAAGTTC->GCTACTACGGGAAAGTTCC
TCCGTGTGGTCGAATAGAC->CCGTGTGGTCGAATAGACG
CAAGAAAGGGGCCAGGCAG->AAGAAAGGGGCCAGGCAGT
TTAGGCTTCAGTATCTGCC->TAGGCTTCAGTATCTGCCG
AAACCACATCTGTTCGCCA->AACCACATCTGTTCGCCAA
GGACCTAACCTTGACCGCC->GACCTAACCTTGACCGCCT
AGAAAGGGGCCAGCCTTAT->GAAAGGGGCCAGCCTTATG
AGGGGCCAGACGCCTCAAT->GGGGCCAGACGCCTCAATA
TTCCGGGCTACTACGGGAA->TCCGGGCTACTACGGGAAA
AACGCGTGTTTCGCTTATC->ACGCGTGTTTCGCTTATCA
GTTCATTGCTCTTTGTGCA->TTCATTGCTCTTTGTGCAG
TAGTCCCCTCGTTTAAACC->AGTCCCCTCGTTTAAACCA
CCAGATCAGTCGCAATCAG->CAGATCAGTCGCAATCAGA
CTGTTCGCGCGCTACCAAG->TGTTCGCGCGCTACCAAGC
GCAGCTTATATGTGTCTTA->CAGCTTATATGTGTCTTAC
TAACCAAGTTGTGGCGACG->AACCAAGTTGTGGCGACGT
CATCATCAAAAGGAGTGTA->ATCATCAAAAGGAGTGTAA
ACTTTAGGCCAAGATTCCT->CTTTAGGCCAAGATTCCTT
TTCTCGATAATCTACGCCT->TCTCGATAATCTACGCCTG
ACTGCTTGGTGGTCGTCAG->CTGCTTGGTGGTCGTCAGC
GGCTTCAGTATCTGCCGGA->GCTTCAGTATCTGCCGGAA
AGCCTTATGCAAGACCTAA->GCCTTATGCAAGACCTAAC
AAGTCCTGCCGCATGAAGC->AGTCCTGCCGCATGAAGCG
GCGCTACCAAGCTAGCCCT->CGCTACCAAGCTAGCCCTA
TATTTTCCACCCCATCCGA->ATTTTCCACCCCATCCGAG
TAAAAGTATCTGATTAGAG->AAAAGTATCTGATTAGAGT
TCCCACTATTTTTACTGAG->CCCACTATTTTTACTGAGG
ACGGAAGGATCTGTCACAT->CGGAAGGATCTGTCACATC
GATACGCAACTCCCGTAGC->ATACGCAACTCCCGTAGCT
CCCTCGCTCGACCACGCGT->CCTCGCTCGACCACGCGTC
GGGGCAAGTCATCGTACAT->GGGCAAGTCATCGTACATT
AATACCGCCACCCTCGCTC->ATACCGCCACCCTCGCTCG
CCCCAGGCTATAAAAGTAT->CCCAGGCTATAAAAGTATC
GTTCGCTATACGCTCAAGA->TTCGCTATACGCTCAAGAA
ATCCGAGGAAGAGGTCATC->TCCGAGGAAGAGGTCATCC
CCTAACTAACCGTTATCTT->CTAACTAACCGTTATCTTT
ATTTCCATGTTCATTGCTC->TTTCCATGTTCATTGCTCT
CTGGTACCAACAACGGCCT->TGGTACCAACAACGGCCTT
AAGGTAAGTCCGAGTTCGC->AGGTAAGTCCGAGTTCGCT
TAAATCCGGAAAAACAAGT->AAATCCGGAAAAACAAGTT
TCTCGATTCCCGCATCTGC->CTCGATTCCCGCATCTGCT
AAATGTGCCTTGGACTAGC->AATGTGCCTTGGACTAGCG
TTCCTTATCGAAGCTTTGA->TCCTTATCGAAGCTTTGAT
CGGCAGTCGTGTCATGGAA->GGCAGTCGTGTCATGGAAT
TAGTCACTGCTTGGTGGTC->AGTCACTGCTTGGTGGTCG
CACTAAGTAGCCTATTCCA->ACTAAGTAGCCTATTCCAG
TAGATTCATGCGCTAGCTC->AGATTCATGCGCTAGCTCA
GGTGTGGAATGACAACCTC->GTGTGGAATGACAACCTCT
CTACGGGAAAGTTCCTAGA->TACGGGAAAGTTCCTAGAT
TCCGCCAACCACATATGTT->CCGCCAACCACATATGTTG
TCGGTGGCTATTAAGTCTG->CGGTGGCTATTAAGTCTGT
GCGCGCTACCAAGCTAGCC->CGCGCTACCAAGCTAGCCC
CGCCAATTGGCGGTCGCGC->GCCAATTGGCGGTCGCGCC
TATCTTTCAACCTCGCCAG->ATCTTTCAACCTCGCCAGC
ATGTCACATATCTGTCGTT->TGTCACATATCTGTCGTTA
TATCACCCCGGAAAGACTC->ATCACCCCGGAAAGACTCA
TAAAAGGCTCAAGAAAGGG->AAAAGGCTCAAGAAAGGGG
CTGTGCTGGTTTCTGGCCT->TGTGCTGGTTTCTGGCCTA
CATGAAGCGCAGTTACGCC->ATGAAGCGCAGTTACGCCA
CTATTTTCCACCCCATCCG->TATTTTCCACCCCATCCGA
CCCGTTACGGAAGGATCTG->CCGTTACGGAAGGATCTGT
GGCAAAGAGCGGAGTATCG->GCAAAGAGCGGAGTATCGG
CTCCATATGCTCAAGAAAG->TCCATATGCTCAAGAAAGG
TGAACAACCAATACCGCCA->GAACAACCAATACCGCCAC
GCGACTGACATTAAGGGAC->CGACTGACATTAAGGGACA
TCCGAGTCATATTCTGCGG->CCGAGTCATATTCTGCGGG
GGATACGCAACTCCCGTAG->GATACGCAACTCCCGTAGC
CCCGGAAAGACTCAGATTG->CCGGAAAGACTCAGATTGA
CTAGCCATCATCAAAAGGA->TAGCCATCATCAAAAGGAG
TGTGCTTTACATCCTTCCG->GTGCTTTACATCCTTCCGT
ATTCCCGCATCTGCTCATG->TTCCCGCATCTGCTCATGT
GGCTTCTCGATAATCTACG->GCTTCTCGATAATCTACGC
TTCCAGGTCAATCTTTCCG->TCCAGGTCAATCTTTCCGC
TACGCCTGAAGGTAAGTCC->ACGCCTGAAGGTAAGTCCG
TACCGAAACATGGTTCCGG->ACCGAAACATGGTTCCGGG
AGTAGCCTATTCCAGGTCA->GTAGCCTATTCCAGGTCAA
CCGTAGCTATACCTCCATA->CGTAGCTATACCTCCATAT
CCAAAGATGGTCGGTAGGC->CAAAGATGGTCGGTAGGCG
AAGAAATCATATTCACGCA->AGAAATCATATTCACGCAA
AGTTCTTCAACTCTTGACC->GTTCTTCAACTCTTGACCT
AGTAAGCGGACCTAACCTT->GTAAGCGGACCTAACCTTG
ACCCTCATCGGGTAGGAGC->CCCTCATCGGGTAGGAGCC
ATGCTGTCATATCAGCTAT->TGCTGTCATATCAGCTATG
TTCCATGTTCATTGCTCTT->TCCATGTTCATTGCTCTTT
TAACAAGGTTTTAGTCCCT->AACAAGGTTTTAGTCCCTA
GGTTCCGGGCTACTACGGG->GTTCCGGGCTACTACGGGA
CTTCCGTTAACGGTCCGAG->TTCCGTTAACGGTCCGAGT
TTCTCGGCTTTGAGCCCTA->TCTCGGCTTTGAGCCCTAG
TTTCAACCTCGCCAGCGTT->TTCAACCTCGCCAGCGTTT
TCGCAATCAGAATGTCGGC->CGCAATCAGAATGTCGGCT
TCCCACATCAATAGTACAT->CCCACATCAATAGTACATG
CCCTAGGGCAAAGAGCGGA->CCTAGGGCAAAGAGCGGAG
CGCCCAGGGTCCTCTCTCG->GCCCAGGGTCCTCTCTCGA
TGATCTCGAGGGTAGAATT->GATCTCGAGGGTAGAATTG
TTGGACTAGCGCTAAAAGG->TGGACTAGCGCTAAAAGGC
CCTCGCTTGAAGAAATCAT->CTCGCTTGAAGAAATCATA
TCAACCTCGCCAGCGTTTA->CAACCTCGCCAGCGTTTAA
GCACTCGGTAGTCCCCTCG->CACTCGGTAGTCCCCTCGT
CGGCTTTGAGCCCTAGGGC->GGCTTTGAGCCCTAGGGCA
ATGATGCCGTTATAGAGTA->TGATGCCGTTATAGAGTAC
TCCGAGCACAGAGTCGTCC->CCGAGCACAGAGTCGTCCG
GTGTCTGCTTGCACATTTC->TGTCTGCTTGCACATTTCC
CTCTTCACGCGACTGACAT->TCTTCACGCGACTGACATT
ATCCGGAAAAACAAGTTGT->TCCGGAAAAACAAGTTGTA
CCAGGTCAATCTTTCCGCA->CAGGTCAATCTTTCCGCAT
ATTGTATTGGCCCATCTAA->TTGTATTGGCCCATCTAAA
CCAAGCTAGCCCTATCACC->CAAGCTAGCCCTATCACCC
GCCTGCAGGAAGCCAGGTG->CCTGCAGGAAGCCAGGTGT
TAGTAAATCTAATTGAACT->AGTAAATCTAATTGAACTC
TCTGCTCATGTCGCCAGCG->CTGCTCATGTCGCCAGCGA
GCACCTAACCTTGACCGCC->CACCTAACCTTGACCGCCT
TTTAGTCCCTAACTAACCG->TTAGTCCCTAACTAACCGT
AACCAAGTTGTGGCGACGT->ACCAAGTTGTGGCGACGTA
CTACCAAGCTAGCCCTATC->TACCAAGCTAGCCCTATCA
TAATGAAAGCCGAGTGTGG->AATGAAAGCCGAGTGTGGT
CCTATTCCAGGTCAATCTT->CTATTCCAGGTCAATCTTT
GCTCAAGAAAGGGGCCAGC->CTCAAGAAAGGGGCCAGCC
AGGATGGGTCTCGCTGTCT->GGATGGGTCTCGCTGTCTC
AATATCCACTTAAGTTAAC->ATATCCACTTAAGTTAACT
TCGCCAGCGACAGTTTACT->CGCCAGCGACAGTTTACTT
TGTAAAAATGTGCCTTGGA->GTAAAAATGTGCCTTGGAC
AGGTAAGTCCGAGTTCGCT->GGTAAGTCCGAGTTCGCTA
AATTATGTTAGTACGTAGA->ATTATGTTAGTACGTAGAC
CACATCTCTGTGCTGGTTT->ACATCTCTGTGCTGGTTTC
AGGCAGTAAGCGGACCTAA->GGCAGTAAGCGGACCTAAC
GTTCTAAATATCCACTTAA->TTCTAAATATCCACTTAAG
CAGATTGATATTCCCGTTA->AGATTGATATTCCCGTTAC
TATACCTCCATATGCTCAA->ATACCTCCATATGCTCAAG
TAACCTTGACCGCCTCTGA->AACCTTGACCGCCTCTGAC
AAAGGGGCCAGCCTTATGC->AAGGGGCCAGCCTTATGCA
AGAAAGGGGCCAGGCAGTA->GAAAGGGGCCAGGCAGTAA
GGTGTCCCGGCAACCTAGT->GTGTCCCGGCAACCTAGTG
CTATAATCTCCGCTCAGTG->TATAATCTCCGCTCAGTGA
GGTAAGTCCGAGTTCGCTA->GTAAGTCCGAGTTCGCTAT
CTATAAAAGTATCTGATTA->TATAAAAGTATCTGATTAG
TAGACTTCGTATTTGCCGG->AGACTTCGTATTTGCCGGG
TGGTCGAATAGACGCTAGT->GGTCGAATAGACGCTAGTC
GGGCAAAGAGCGGAGTATC->GGCAAAGAGCGGAGTATCG
CTTCAACTCTTGACCTCCG->TTCAACTCTTGACCTCCGC
TCCGCTCAGTGAACAACCA->CCGCTCAGTGAACAACCAA
GAGGAAGAGGTCATCCCAC->AGGAAGAGGTCATCCCACA
AGCTCATCGGAGGCCAGTT->GCTCATCGGAGGCCAGTTG
GAGTCGCGAAAGGTCGGTG->AGTCGCGAAAGGTCGGTGG
AATCAGAATGTCGGCTCGA->ATCAGAATGTCGGCTCGAA
CTTTCCGCATTATGCTCAC->TTTCCGCATTATGCTCACC
CAACCTAGTGAAGCTCATC->AACCTAGTGAAGCTCATCG
ATCCCCTTCCCTATTTTCC->TCCCCTTCCCTATTTTCCA
CAGTGTTCATTTCTTGTTA->AGTGTTCATTTCTTGTTAA
CACTGGTATAGTTATTGAG->ACTGGTATAGTTATTGAGG
CTCGAATTATGTTAGTACG->TCGAATTATGTTAGTACGT
TCTTCAACTCTTGACCTCC->CTTCAACTCTTGACCTCCG
AGTATCTGATTAGAGTCGC->GTATCTGATTAGAGTCGCG
AAGAGGTCATCCCACATCA->AGAGGTCATCCCACATCAA
TCGTCAGCGGTTCCCGACC->CGTCAGCGGTTCCCGACCG
TGGTACCAACAACGGCCTT->GGTACCAACAACGGCCTTG
AATTTCAGACTACTCTAAG->ATTTCAGACTACTCTAAGT
CCGTTATCTTTCAACCTCG->CGTTATCTTTCAACCTCGC
ACCTCTTCACGCGACTGAC->CCTCTTCACGCGACTGACA
TCTGGACAGACCCCAGGCT->CTGGACAGACCCCAGGCTA
CCAGGGTCCTCTCTCGATT->CAGGGTCCTCTCTCGATTC
CTTGCTTCTATGATGCCGT->TTGCTTCTATGATGCCGTT
AAGTCTGTTCGCGCGCTAC->AGTCTGTTCGCGCGCTACC
CAAAAGGAGTGTAAAAATG->AAAAGGAGTGTAAAAATGT
TCTCGATAATCTACGCCTG->CTCGATAATCTACGCCTGA
CGTTTGGCATGGTGTATAT->GTTTGGCATGGTGTATATA
ATCCACCGCGGTGCGGCAG->TCCACCGCGGTGCGGCAGT
TGGTCGGTAGGCGGGCCAA->GGTCGGTAGGCGGGCCAAT
GTATCGGTCATCGATAAAT->TATCGGTCATCGATAAATG
GCCAGTAGTATACTGCACC->CCAGTAGTATACTGCACCT
TGGCGGTCGCGCCCAGGGT->GGCGGTCGCGCCCAGGGTC
ATACAACGCCAGCTGACGC->TACAACGCCAGCTGACGCG
ACTCTCCCACTATTTTTAC->CTCTCCCACTATTTTTACT
TTACTTGTGCTTTACATCC->TACTTGTGCTTTACATCCT
GTTCTGGTGTCCCGGCAAC->TTCTGGTGTCCCGGCAACC
TAAGTCCTGCCGCATGAAG->AAGTCCTGCCGCATGAAGC
TGTATATATTATTACGACA->GTATATATTATTACGACAT
AGAAATCATATTCACGCAA->GAAATCATATTCACGCAAA
TTAGTCCCTAACTAACCGT->TAGTCCCTAACTAACCGTT
TAGCTATACCTCCATATGC->AGCTATACCTCCATATGCT
TTCACGCAAACCCAAATAA->TCACGCAAACCCAAATAAT
GTGACGGTGTGGAATGACA->TGACGGTGTGGAATGACAA
GTTTGGCATGGTGTATATA->TTTGGCATGGTGTATATAT
CGCGGTGCGGCAGTCGTGT->GCGGTGCGGCAGTCGTGTC
TAACCTTGACCGCCTCCCG->AACCTTGACCGCCTCCCGT
TCTGACCACTAGCGCACAA->CTGACCACTAGCGCACAAG
TAGGGCAAAGAGCGGAGTA->AGGGCAAAGAGCGGAGTAT
TCAAGAAAGGGGCCAGGCA->CAAGAAAGGGGCCAGGCAG
TCCATGTTCATTGCTCTTT->CCATGTTCATTGCTCTTTG
AAAGGTCGGTGGCTATTAA->AAGGTCGGTGGCTATTAAG
CTTGCACATTTCCTAGTCA->TTGCACATTTCCTAGTCAC
GGCAAGTCATCGTACATTG->GCAAGTCATCGTACATTGC
CAAGACCTAACCTTGACCG->AAGACCTAACCTTGACCGC
TTCAACCTCGCCAGCGTTT->TCAACCTCGCCAGCGTTTA
CAAGGTTTTAGTCCCTAAC->AAGGTTTTAGTCCCTAACT
CGTAGCGGACGCATCCGAG->GTAGCGGACGCATCCGAGC
GAAGAGGTCATCCCACATC->AAGAGGTCATCCCACATCA
GAAGCCAGGTGTCTGCTTG->AAGCCAGGTGTCTGCTTGC
CTTAAGTTAACTCTATAAT->TTAAGTTAACTCTATAATC
CCAGGCTATAAAAGTATCT->CAGGCTATAAAAGTATCTG
TTAAGGGACAACTACATTG->TAAGGGACAACTACATTGT
TCCGGGGGCAAGTCATCGT->CCGGGGGCAAGTCATCGTA
TAAGGGACAACTACATTGT->AAGGGACAACTACATTGTA
TCGTATTTGCCGGGTAGTA->CGTATTTGCCGGGTAGTAA
TCCGTTAACGGTCCGAGTC->CCGTTAACGGTCCGAGTCA
TCAACTCTTGACCTCCGCC->CAACTCTTGACCTCCGCCA
AGTCCCTAACTAACCGTTA->GTCCCTAACTAACCGTTAT
TAGCGCTAAAAGGCTCAAG->AGCGCTAAAAGGCTCAAGA
CGCCTCAATAACCTAACCT->GCCTCAATAACCTAACCTT
TGTCGGCTCGAATTATGTT->GTCGGCTCGAATTATGTTA
CTCCCAGATCAGTCGCAAT->TCCCAGATCAGTCGCAATC
AGTGTAAAAATGTGCCTTG->GTGTAAAAATGTGCCTTGG
CCCCCAGTCAGTGTTCATT->CCCCAGTCAGTGTTCATTT
GCAAAGAGCGGAGTATCGG->CAAAGAGCGGAGTATCGGT
CCCAGCAAGTTCCCTAACA->CCAGCAAGTTCCCTAACAA
GGGCCAGACGCCTCAATAA->GGCCAGACGCCTCAATAAC
CAAGAAAGGGGCCAGCCTT->AAGAAAGGGGCCAGCCTTA
ATTGAAGTGGTAAAAGGAT->TTGAAGTGGTAAAAGGATG
GGACTCCCAGATCAGTCGC->GACTCCCAGATCAGTCGCA
TTATGTTAGTACGTAGACT->TATGTTAGTACGTAGACTT
TTATAGAGTACCAAAGATG->TATAGAGTACCAAAGATGG
CTATGTCACATATCTGTCG->TATGTCACATATCTGTCGT
AGGCTATAAAAGTATCTGA->GGCTATAAAAGTATCTGAT
TTGTGGCGACGTACGATAC->TGTGGCGACGTACGATACA
TCTGCTTGCACATTTCCTA->CTGCTTGCACATTTCCTAG
TTTCGCTTATCATTGCCTA->TTCGCTTATCATTGCCTAA
CAAATAATTAACACTGGTA->AAATAATTAACACTGGTAT
GATTCCCGCATCTGCTCAT->ATTCCCGCATCTGCTCATG
CAAGAAAGGGGCCAGTAGT->AAGAAAGGGGCCAGTAGTA
CATGGATTCATACCGAAAC->ATGGATTCATACCGAAACA
AAAAGGCTCAAGAAAGGGG->AAAGGCTCAAGAAAGGGGC
ATCTAAATCCGGAAAAACA->TCTAAATCCGGAAAAACAA
GTTAACGGTCCGAGTCATA->TTAACGGTCCGAGTCATAT
CGTGTGGTCGAATAGACGC->GTGTGGTCGAATAGACGCT
TCGCCAGCGTTTAAAAAGG->CGCCAGCGTTTAAAAAGGC
TCCCTAACTAACCGTTATC->CCCTAACTAACCGTTATCT
TCTACGCCTGAAGGTAAGT->CTACGCCTGAAGGTAAGTC
TCAATAACCTAACCTTGAC->CAATAACCTAACCTTGACC
GTCGCCAGCGACAGTTTAC->TCGCCAGCGACAGTTTACT
TCAGACTACTCTAAGTAAT->CAGACTACTCTAAGTAATG
CGCTTGAAGAAATCATATT->GCTTGAAGAAATCATATTC
TTCCCTAACAAGGTTTTAG->TCCCTAACAAGGTTTTAGT
CATCAATAGTACATGGATT->ATCAATAGTACATGGATTC
CGGACGCATCCGAGCACAG->GGACGCATCCGAGCACAGA
CATCTGCTCATGTCGCCAG->ATCTGCTCATGTCGCCAGC
CATCCCACATCAATAGTAC->ATCCCACATCAATAGTACA
CCTGAAGGTAAGTCCGAGT->CTGAAGGTAAGTCCGAGTT
AAAAACAAGTTGTACATAT->AAAACAAGTTGTACATATA
GCCAGCGACAGTTTACTTG->CCAGCGACAGTTTACTTGT
CAACAACGGCCTTGCTTCT->AACAACGGCCTTGCTTCTA
CGTAGACTTCGTATTTGCC->GTAGACTTCGTATTTGCCG
AATCCCCTTCCCTATTTTC->ATCCCCTTCCCTATTTTCC
AATAGACGCTAGTCCCCCA->ATAGACGCTAGTCCCCCAG
TCCACCGCGGTGCGGCAGT->CCACCGCGGTGCGGCAGTC
TTACATCCTTCCGTTAACG->TACATCCTTCCGTTAACGG
ACCCAGCAAGTTCCCTAAC->CCCAGCAAGTTCCCTAACA
GCGTCAGCTGTATTCACCC->CGTCAGCTGTATTCACCCT
CAGTCGCAATCAGAATGTC->AGTCGCAATCAGAATGTCG
CAATACCGCCACCCTCGCT->AATACCGCCACCCTCGCTC
GGGACTCCCAGATCAGTCG->GGACTCCCAGATCAGTCGC
CACGCAAACCCAAATAATT->ACGCAAACCCAAATAATTA
ATTCCAGGTCAATCTTTCC->TTCCAGGTCAATCTTTCCG
AGGGACAACTACATTGTAT->GGGACAACTACATTGTATT
CTAACTAACCGTTATCTTT->TAACTAACCGTTATCTTTC
CCAGGCAGTAAGCGGACCT->CAGGCAGTAAGCGGACCTA
AAGAAAGGGGCCAGACGCC->AGAAAGGGGCCAGACGCCT
CCTCTGCCGTTTTATTGAA->CTCTGCCGTTTTATTGAAG
CCGTGTGGTCGAATAGACG->CGTGTGGTCGAATAGACGC
TGCTCAAGAAAGGGGCCAG->GCTCAAGAAAGGGGCCAGT
TCTCCCACTATTTTTACTG->CTCCCACTATTTTTACTGA
TGTGCTGGTTTCTGGCCTA->GTGCTGGTTTCTGGCCTAT
CAGTTCTTCAACTCTTGAC->AGTTCTTCAACTCTTGACC
TTATTACGACATAAGTCCT->TATTACGACATAAGTCCTG
CATATACAACGCCAGCTGA->ATATACAACGCCAGCTGAC
TGACATTAAGGGACAACTA->GACATTAAGGGACAACTAC
AGGAAGAGGTCATCCCACA->GGAAGAGGTCATCCCACAT
AAACATGGTTCCGGGCTAC->AACATGGTTCCGGGCTACT
ACCACATCTGTTCGCCAAT->CCACATCTGTTCGCCAATT
GCCACTCTCCCACTATTTT->CCACTCTCCCACTATTTTT
TAGGCTTCAGTATCTGCCG->AGGCTTCAGTATCTGCCGG
ATTAAGTCTGTTCGCGCGC->TTAAGTCTGTTCGCGCGCT
AATCCGGAAAAACAAGTTG->ATCCGGAAAAACAAGTTGT
TGGTGCAAGTACACCACCC->GGTGCAAGTACACCACCCA
AGACGCCTCAATAACCTAA->GACGCCTCAATAACCTAAC
ATTCTGCGGGGAGTTCTGG->TTCTGCGGGGAGTTCTGGT
GTAGGCGGGCCAATATAAT->TAGGCGGGCCAATATAATG
CCGGGGGCAAGTCATCGTA->CGGGGGCAAGTCATCGTAC
AATTGGCGGTCGCGCCCAG->ATTGGCGGTCGCGCCCAGG
TCAGTATCTGCCGGAATTT->CAGTATCTGCCGGAATTTC
TCCGCATTATGCTCACCTC->CCGCATTATGCTCACCTCT
AAAGACTCAGATTGATATT->AAGACTCAGATTGATATTC
AGCGCACAAGAAATCCCCT->GCGCACAAGAAATCCCCTT
GTCCGAGTTCGCTATACGC->TCCGAGTTCGCTATACGCT
CAGCTGTATTCACCCTCAT->AGCTGTATTCACCCTCATC
CCTCCATATGCTCAAGAAA->CTCCATATGCTCAAGAAAG
CATCCGAGGAAGAGGTCAT->ATCCGAGGAAGAGGTCATC
CTCGCTCGACCACGCGTCA->TCGCTCGACCACGCGTCAG
CGCGGATCCACCGCGGTGC->GCGGATCCACCGCGGTGCG
CGAATTATGTTAGTACGTA->GAATTATGTTAGTACGTAG
CAGCTATGTCACATATCTG->AGCTATGTCACATATCTGT
AGGTTGAGTGACGGTGTGG->GGTTGAGTGACGGTGTGGA
ATGTTGCACTCGGTAGTCC->TGTTGCACTCGGTAGTCCC
AGATTCCTTATCGAAGCTT->GATTCCTTATCGAAGCTTT
CATCGTACATTGCACACTA->ATCGTACATTGCACACTAA
ATGCAAGACCTAACCTTGA->TGCAAGACCTAACCTTGAC
AAAGCCCTCTGCCGTTTTA->AAGCCCTCTGCCGTTTTAT
GGTAGGAGCCCTCAGAGGA->GTAGGAGCCCTCAGAGGAT
GTGCAAGTACACCACCCAG->TGCAAGTACACCACCCAGC
GGTACCAACAACGGCCTTG->GTACCAACAACGGCCTTGC
CGTCTGGTACCAACAACGG->GTCTGGTACCAACAACGGC
GGCCTATACGGGACTCCCA->GCCTATACGGGACTCCCAG
TACGACATAAGTCCTGCCG->ACGACATAAGTCCTGCCGC
CAGGCTATAAAAGTATCTG->AGGCTATAAAAGTATCTGA
ATGGAATAGCGTAACGCGT->TGGAATAGCGTAACGCGTG
GGGCCAATATAATGGGCCA->GGCCAATATAATGGGCCAA
AGTCGCGAAAGGTCGGTGG->GTCGCGAAAGGTCGGTGGC
ACAACCAATACCGCCACCC->CAACCAATACCGCCACCCT
ACCTTGACCGCCTCCTGCG->CCTTGACCGCCTCCTGCGA
CTCTGTGCTGGTTTCTGGC->TCTGTGCTGGTTTCTGGCC
GCGGAGTATCGGTCATCGA->CGGAGTATCGGTCATCGAT
GTTAATTGATTCCGGTTCT->TTAATTGATTCCGGTTCTA
GGTTTCTGGCCTATACGGG->GTTTCTGGCCTATACGGGA
TAAAAAGGCTTCTCGATAA->AAAAAGGCTTCTCGATAAT
GGCCCATCTAAATCCGGAA->GCCCATCTAAATCCGGAAA
AGCAAGTTCCCTAACAAGG->GCAAGTTCCCTAACAAGGT
TCTGACCGATTCTCGGCTT->CTGACCGATTCTCGGCTTT
AATTGTCTGGGTCCCGTAG->ATTGTCTGGGTCCCGTAGC
AACCTTGACCGCCTCCCGT->ACCTTGACCGCCTCCCGTT
TTAAAAAGGCTTCTCGATA->TAAAAAGGCTTCTCGATAA
AGTACCAAAGATGGTCGGT->GTACCAAAGATGGTCGGTA
AAGGGGCCAGACGCCTCAA->AGGGGCCAGACGCCTCAAT
CTAACCTTGACCGCCTCGC->TAACCTTGACCGCCTCGCT
TCCCGTAGCGGACGCATCC->CCCGTAGCGGACGCATCCG
CTGACATTAAGGGACAACT->TGACATTAAGGGACAACTA
CAGGAAGCCAGGTGTCTGC->AGGAAGCCAGGTGTCTGCT
ACCGCCTCCTGCGAGCCTG->CCGCCTCCTGCGAGCCTGC
GTCGCGCCCAGGGTCCTCT->TCGCGCCCAGGGTCCTCTC
AGGGTAGAATTGTCTGGGT->GGGTAGAATTGTCTGGGTC
GCCTTGCTTCTATGATGCC->CCTTGCTTCTATGATGCCG
CCTCGTTTAAACCACATCT->CTCGTTTAAACCACATCTG
AGACCCCAGGCTATAAAAG->GACCCCAGGCTATAAAAGT
ACTCTATAATCTCCGCTCA->CTCTATAATCTCCGCTCAG
GGTTCCCGACCGTCTGGTA->GTTCCCGACCGTCTGGTAC
GGTGCGGCAGTCGTGTCAT->GTGCGGCAGTCGTGTCATG
CCTTCCCTATTTTCCACCC->CTTCCCTATTTTCCACCCC
GGGCCAGGCAGTAAGCGGA->GGCCAGGCAGTAAGCGGAC
CGCTAAAAGGCTCAAGAAA->GCTAAAAGGCTCAAGAAAG
TGGATTCATACCGAAACAT->GGATTCATACCGAAACATG
GTTACGGAAGGATCTGTCA->TTACGGAAGGATCTGTCAC
TACGCTCAAGAAAGGGGCC->ACGCTCAAGAAAGGGGCCA
GGCCAGGCAGTAAGCGGAC->GCCAGGCAGTAAGCGGACC
ATGGTGTATATATTATTAC->TGGTGTATATATTATTACG
AGTATCGGTCATCGATAAA->GTATCGGTCATCGATAAAT
AATAATCTGGACAGACCCC->ATAATCTGGACAGACCCCA
CGTCCGGGGGCAAGTCATC->GTCCGGGGGCAAGTCATCG
ATGTGCCTTGGACTAGCGC->TGTGCCTTGGACTAGCGCT
ATAAGTCCTGCCGCATGAA->TAAGTCCTGCCGCATGAAG
ACCTCTGACCGATTCTCGG->CCTCTGACCGATTCTCGGC
TGTCTGGGTCCCGTAGCGG->GTCTGGGTCCCGTAGCGGA
GGAGGCCAGTTGCTAGCCA->GAGGCCAGTTGCTAGCCAT
TCGTCCGGGGGCAAGTCAT->CGTCCGGGGGCAAGTCATC
GAAGTGGTAAAAGGATGGG->AAGTGGTAAAAGGATGGGT
CTCTGACCGATTCTCGGCT->TCTGACCGATTCTCGGCTT
CAAGAAAGGGGCCAGACGC->AAGAAAGGGGCCAGACGCC
GAAGCTCATCGGAGGCCAG->AAGCTCATCGGAGGCCAGT
CTCGGTAGTCCCCTCGTTT->TCGGTAGTCCCCTCGTTTA
CGTCAGCGGTTCCCGACCG->GTCAGCGGTTCCCGACCGT
GTCATCCCACATCAATAGT->TCATCCCACATCAATAGTA
ATAGTACATGGATTCATAC->TAGTACATGGATTCATACC
AAGCTTTGATCTCGAGGGT->AGCTTTGATCTCGAGGGTA
AGGCCAAGATTCCTTATCG->GGCCAAGATTCCTTATCGA
CTCATCGGAGGCCAGTTGC->TCATCGGAGGCCAGTTGCT
AACATGGTTCCGGGCTACT->ACATGGTTCCGGGCTACTA
GGCTCGAATTATGTTAGTA->GCTCGAATTATGTTAGTAC
GAATTGTCTGGGTCCCGTA->AATTGTCTGGGTCCCGTAG
GTACCAAAGATGGTCGGTA->TACCAAAGATGGTCGGTAG
CCTCAGAGGATGAAAGCCC->CTCAGAGGATGAAAGCCCT
GCTCACCTCTTCACGCGAC->CTCACCTCTTCACGCGACT
TCCCAGATCAGTCGCAATC->CCCAGATCAGTCGCAATCA
GAAGGATCTGTCACATCTC->AAGGATCTGTCACATCTCT
CTCAGTTCTTCAACTCTTG->TCAGTTCTTCAACTCTTGA
TATATGTGTCTTACCTCAA->ATATGTGTCTTACCTCAAC
AAAGGGGCCAGGCAGTAAG->AAGGGGCCAGGCAGTAAGC
CCCCAGTCAGTGTTCATTT->CCCAGTCAGTGTTCATTTC
TTCCGCATTATGCTCACCT->TCCGCATTATGCTCACCTC
CTGAAGGTAAGTCCGAGTT->TGAAGGTAAGTCCGAGTTC
TCATGCGCTAGCTCAAGAA->CATGCGCTAGCTCAAGAAA
TTATTGAGGAATCGTCCAT->TATTGAGGAATCGTCCATC
TTCTGGCCTATACGGGACT->TCTGGCCTATACGGGACTC
GACGCGGATCCACCGCGGT->ACGCGGATCCACCGCGGTG
GGTTTTAGTCCCTAACTAA->GTTTTAGTCCCTAACTAAC
TGTGGAATGACAACCTCTG->GTGGAATGACAACCTCTGA
CCGTTATAGAGTACCAAAG->CGTTATAGAGTACCAAAGA
GTAAAAATGTGCCTTGGAC->TAAAAATGTGCCTTGGACT
TCAAAAGGAGTGTAAAAAT->CAAAAGGAGTGTAAAAATG
TATAGTTATTGAGGAATCG->ATAGTTATTGAGGAATCGT
CATCTCTGTGCTGGTTTCT->ATCTCTGTGCTGGTTTCTG
AGATTGATATTCCCGTTAC->GATTGATATTCCCGTTACG
CCCCATCCGAGGAAGAGGT->CCCATCCGAGGAAGAGGTC
CTTGGACTAGCGCTAAAAG->TTGGACTAGCGCTAAAAGG
ATGAAGCGCAGTTACGCCA->TGAAGCGCAGTTACGCCAC
CCGAAACATGGTTCCGGGC->CGAAACATGGTTCCGGGCT
CCACTATTTTTACTGAGGA->CACTATTTTTACTGAGGAT
GCCTCGCTTGAAGAAATCA->CCTCGCTTGAAGAAATCAT
CATCGATAAATGCTGTCAT->ATCGATAAATGCTGTCATA
TGACCGCCTCTGACCACTA->GACCGCCTCTGACCACTAG
CCCTAACAAGGTTTTAGTC->CCTAACAAGGTTTTAGTCC
GGTCCGAGTCATATTCTGC->GTCCGAGTCATATTCTGCG
TCGTTTAAACCACATCTGT->CGTTTAAACCACATCTGTT
AGTTACGCCACTCTCCCAC->GTTACGCCACTCTCCCACT
ATGCTCAAGAAAGGGGCCA->TGCTCAAGAAAGGGGCCAG
CGCTCAAGAAAGGGGCCAG->GCTCAAGAAAGGGGCCAGC
GGTTGAGTGACGGTGTGGA->GTTGAGTGACGGTGTGGAA
TGCTCTTTGTGCAGCTTAT->GCTCTTTGTGCAGCTTATA
GGGAGTTCTGGTGTCCCGG->GGAGTTCTGGTGTCCCGGC
CAAGCTAGCCCTATCACCC->AAGCTAGCCCTATCACCCC
TAAGTCCGAGTTCGCTATA->AAGTCCGAGTTCGCTATAC
GGCCAGACGCCTCAATAAC->GCCAGACGCCTCAATAACC
CCCTATCACCCCGGAAAGA->CCTATCACCCCGGAAAGAC
CGTTTAAAAAGGCTTCTCG->GTTTAAAAAGGCTTCTCGA
TCCGGTTCTAAATATCCAC->CCGGTTCTAAATATCCACT
ACCTCCATATGCTCAAGAA->CCTCCATATGCTCAAGAAA
GTCAGCTGTATTCACCCTC->TCAGCTGTATTCACCCTCA
TCTATAATCTCCGCTCAGT->CTATAATCTCCGCTCAGTG
ACCACTAGCGCACAAGAAA->CCACTAGCGCACAAGAAAT
GGCCAATATAATGGGCCAA->GCCAATATAATGGGCCAAT
TCAGATTGATATTCCCGTT->CAGATTGATATTCCCGTTA
CAGGGTCCTCTCTCGATTC->AGGGTCCTCTCTCGATTCC
TGTGTCTTACCTCAACTTT->GTGTCTTACCTCAACTTTA
AACTCCCGTAGCTATACCT->ACTCCCGTAGCTATACCTC
ACCGAAACATGGTTCCGGG->CCGAAACATGGTTCCGGGC
GTGCTGGTTTCTGGCCTAT->TGCTGGTTTCTGGCCTATA
GTTACGCCACTCTCCCACT->TTACGCCACTCTCCCACTA
ATCTTTCAACCTCGCCAGC->TCTTTCAACCTCGCCAGCG
TACGGAAGGATCTGTCACA->ACGGAAGGATCTGTCACAT
GGGTAGGAGCCCTCAGAGG->GGTAGGAGCCCTCAGAGGA
CAACGCCAGCTGACGCGGA->AACGCCAGCTGACGCGGAT
AAGAAAGGGGCCAGTAGTA->AGAAAGGGGCCAGTAGTAT
CGCTCAGTGAACAACCAAT->GCTCAGTGAACAACCAATA
AGTCCTGCCGCATGAAGCG->GTCCTGCCGCATGAAGCGC
TGCGGCAGTCGTGTCATGG->GCGGCAGTCGTGTCATGGA
CGGGGGCAAGTCATCGTAC->GGGGGCAAGTCATCGTACA
CCATCATCAAAAGGAGTGT->CATCATCAAAAGGAGTGTA
AAAGGAGTGTAAAAATGTG->AAGGAGTGTAAAAATGTGC
ACTGGTATAGTTATTGAGG->CTGGTATAGTTATTGAGGA
GGGTAGAATTGTCTGGGTC->GGTAGAATTGTCTGGGTCC
ACCGCCTCCCGTTTGGCAT->CCGCCTCCCGTTTGGCATG
CCTCCGCCAACCACATATG->CTCCGCCAACCACATATGT
ACCGCCTCGCTTGAAGAAA->CCGCCTCGCTTGAAGAAAT
TCAAGAAAGGGGCCAGTAG->CAAGAAAGGGGCCAGTAGT
GGTCGCGCCCAGGGTCCTC->GTCGCGCCCAGGGTCCTCT
AGCGTTTAAAAAGGCTTCT->GCGTTTAAAAAGGCTTCTC
CCTTATGCAAGACCTAACC->CTTATGCAAGACCTAACCT
GTGCGGCAGTCGTGTCATG->TGCGGCAGTCGTGTCATGG
GTAGTATACTGCACCTAAC->TAGTATACTGCACCTAACC
TTGTCTGGGTCCCGTAGCG->TGTCTGGGTCCCGTAGCGG
CGCTACCAAGCTAGCCCTA->GCTACCAAGCTAGCCCTAT
ATCTAATTGAACTCAGTTC->TCTAATTGAACTCAGTTCT
TCCCTAACAAGGTTTTAGT->CCCTAACAAGGTTTTAGTC
GCTTATATGTGTCTTACCT->CTTATATGTGTCTTACCTC
CTAACCGTTATCTTTCAAC->TAACCGTTATCTTTCAACC
TAGGTTGAGTGACGGTGTG->AGGTTGAGTGACGGTGTGG
CACGCGTCAGCTGTATTCA->ACGCGTCAGCTGTATTCAC
ATCAATAGTACATGGATTC->TCAATAGTACATGGATTCA
CGTTTTATTGAAGTGGTAA->GTTTTATTGAAGTGGTAAA
ATATACAACGCCAGCTGAC->TATACAACGCCAGCTGACG
GCCCTCAGAGGATGAAAGC->CCCTCAGAGGATGAAAGCC
GAGTCATATTCTGCGGGGA->AGTCATATTCTGCGGGGAG
CATTGCCTAACCAAGTTGT->ATTGCCTAACCAAGTTGTG
ACCACGCGTCAGCTGTATT->CCACGCGTCAGCTGTATTC
AAGCGGACCTAACCTTGAC->AGCGGACCTAACCTTGACC
AATCTCCGCTCAGTGAACA->ATCTCCGCTCAGTGAACAA
CTAAATCCGGAAAAACAAG->TAAATCCGGAAAAACAAGT
GTCATGGAATAGCGTAACG->TCATGGAATAGCGTAACGC
AGAAAGGGGCCAGACGCCT->GAAAGGGGCCAGACGCCTC
TATATTATTACGACATAAG->ATATTATTACGACATAAGT
CCCAGTCAGTGTTCATTTC->CCAGTCAGTGTTCATTTCT
CATCCGTGTGGTCGAATAG->ATCCGTGTGGTCGAATAGA
ACCGTTATCTTTCAACCTC->CCGTTATCTTTCAACCTCG
TTGCCGGGTAGTAAATCTA->TGCCGGGTAGTAAATCTAA
GGGGGCAAGTCATCGTACA->GGGGCAAGTCATCGTACAT
TGTCGCCAGCGACAGTTTA->GTCGCCAGCGACAGTTTAC
AGTCGTGTCATGGAATAGC->GTCGTGTCATGGAATAGCG
ACCCTCGCTCGACCACGCG->CCCTCGCTCGACCACGCGT
GACGCATCCGAGCACAGAG->ACGCATCCGAGCACAGAGT
CACAAGAAATCCCCTTCCC->ACAAGAAATCCCCTTCCCT
GCAAGTCATCGTACATTGC->CAAGTCATCGTACATTGCA
CCGCGGTGCGGCAGTCGTG->CGCGGTGCGGCAGTCGTGT
TATCAGCTATGTCACATAT->ATCAGCTATGTCACATATC
GAAAGTTCCTAGATTCATG->AAAGTTCCTAGATTCATGC
TAGCCTATTCCAGGTCAAT->AGCCTATTCCAGGTCAATC
ACCACATATGTTGCACTCG->CCACATATGTTGCACTCGG
AAAAAGGCTTCTCGATAAT->AAAAGGCTTCTCGATAATC
CAATCAGAATGTCGGCTCG->AATCAGAATGTCGGCTCGA
TATGCTCAAGAAAGGGGCC->ATGCTCAAGAAAGGGGCCA
GTTTCGCTTATCATTGCCT->TTTCGCTTATCATTGCCTA
AAATCATATTCACGCAAAC->AATCATATTCACGCAAACC
ATATTCCCGTTACGGAAGG->TATTCCCGTTACGGAAGGA
TGCAAGACCTAACCTTGAC->GCAAGACCTAACCTTGACC
GCCATCATCAAAAGGAGTG->CCATCATCAAAAGGAGTGT
CAACCTCTGACCGATTCTC->AACCTCTGACCGATTCTCG
TATTCACGCAAACCCAAAT->ATTCACGCAAACCCAAATA
TTCTGGTGTCCCGGCAACC->TCTGGTGTCCCGGCAACCT
ACAACTACATTGTATTGGC->CAACTACATTGTATTGGCC
TTGTGCAGCTTATATGTGT->TGTGCAGCTTATATGTGTC
TTCTATGATGCCGTTATAG->TCTATGATGCCGTTATAGA
CGGTCCGAGTCATATTCTG->GGTCCGAGTCATATTCTGC
ACCGCCACCCTCGCTCGAC->CCGCCACCCTCGCTCGACC
GATATTCCCGTTACGGAAG->ATATTCCCGTTACGGAAGG
TTCACCCTCATCGGGTAGG->TCACCCTCATCGGGTAGGA
CAAGAAATCCCCTTCCCTA->AAGAAATCCCCTTCCCTAT
AATGCTGTCATATCAGCTA->ATGCTGTCATATCAGCTAT
CGCAGTTACGCCACTCTCC->GCAGTTACGCCACTCTCCC
CATCCTTCCGTTAACGGTC->ATCCTTCCGTTAACGGTCC
AGCCCTCAGAGGATGAAAG->GCCCTCAGAGGATGAAAGC
TTTGGCATGGTGTATATAT->TTGGCATGGTGTATATATT
ATTGATTCCGGTTCTAAAT->TTGATTCCGGTTCTAAATA
CGTACATTGCACACTAAGT->GTACATTGCACACTAAGTA
CGACCACGCGTCAGCTGTA->GACCACGCGTCAGCTGTAT
ATATTATTACGACATAAGT->TATTATTACGACATAAGTC
CGCCTCGCTTGAAGAAATC->GCCTCGCTTGAAGAAATCA
CGTACGATACAATAATCTG->GTACGATACAATAATCTGG
AACCCAAATAATTAACACT->ACCCAAATAATTAACACTG
TCCCGGCAACCTAGTGAAG->CCCGGCAACCTAGTGAAGC
GCCAGCTGACGCGGATCCA->CCAGCTGACGCGGATCCAC
CATATTCTGCGGGGAGTTC->ATATTCTGCGGGGAGTTCT
TATCTGTCGTTAGGCTTCA->ATCTGTCGTTAGGCTTCAG
CGCATGAAGCGCAGTTACG->GCATGAAGCGCAGTTACGC
AACTCTTGACCTCCGCCAA->ACTCTTGACCTCCGCCAAC
CACATATGTTGCACTCGGT->ACATATGTTGCACTCGGTA
TGACCGATTCTCGGCTTTG->GACCGATTCTCGGCTTTGA
GTACCAACAACGGCCTTGC->TACCAACAACGGCCTTGCT
TGACCGCCTCCCGTTTGGC->GACCGCCTCCCGTTTGGCA
GTCACATCTCTGTGCTGGT->TCACATCTCTGTGCTGGTT
GTGGAATGACAACCTCTGA->TGGAATGACAACCTCTGAC
GTAGCCTATTCCAGGTCAA->TAGCCTATTCCAGGTCAAT
GTCGTGTCATGGAATAGCG->TCGTGTCATGGAATAGCGT
CCTTGACCGCCTCCTGCGA->CTTGACCGCCTCCTGCGAG
TCGAATTATGTTAGTACGT->CGAATTATGTTAGTACGTA
TCAGCTGTATTCACCCTCA->CAGCTGTATTCACCCTCAT
CGCCAGCGTTTAAAAAGGC->GCCAGCGTTTAAAAAGGCT
TACTTGTGCTTTACATCCT->ACTTGTGCTTTACATCCTT
GGACGCATCCGAGCACAGA->GACGCATCCGAGCACAGAG
TCCGAGTTCGCTATACGCT->CCGAGTTCGCTATACGCTC
GCAACCTAGTGAAGCTCAT->CAACCTAGTGAAGCTCATC
TATAATCTCCGCTCAGTGA->ATAATCTCCGCTCAGTGAA
ACGCGTGTTTCGCTTATCA->CGCGTGTTTCGCTTATCAT
CAGAGGATGAAAGCCCTCT->AGAGGATGAAAGCCCTCTG
GCTACTACGGGAAAGTTCC->CTACTACGGGAAAGTTCCT
GCACAAGAAATCCCCTTCC->CACAAGAAATCCCCTTCCC
AGACTACTCTAAGTAATGA->GACTACTCTAAGTAATGAA
GCGGTTCCCGACCGTCTGG->CGGTTCCCGACCGTCTGGT
ACCTCGCCAGCGTTTAAAA->CCTCGCCAGCGTTTAAAAA
CCCGTAGCTATACCTCCAT->CCGTAGCTATACCTCCATA
CGCGTGTTTCGCTTATCAT->GCGTGTTTCGCTTATCATT
GCCAACCACATATGTTGCA->CCAACCACATATGTTGCAC
GCCACCCTCGCTCGACCAC->CCACCCTCGCTCGACCACG
TAATCTGGACAGACCCCAG->AATCTGGACAGACCCCAGG
CTAACCTTGACCGCCTCCT->TAACCTTGACCGCCTCCTG
TGCCGGAATTTCCATGTTC->GCCGGAATTTCCATGTTCA
TTACTGAGGATACGCAACT->TACTGAGGATACGCAACTC
AGGGCAAAGAGCGGAGTAT->GGGCAAAGAGCGGAGTATC
TTTGTGCAGCTTATATGTG->TTGTGCAGCTTATATGTGT
ACTACATTGTATTGGCCCA->CTACATTGTATTGGCCCAT
CATCGGGTAGGAGCCCTCA->ATCGGGTAGGAGCCCTCAG
AGTCCCCTCGTTTAAACCA->GTCCCCTCGTTTAAACCAC
TGTCTGCTTGCACATTTCC->GTCTGCTTGCACATTTCCT
AACTAACCGTTATCTTTCA->ACTAACCGTTATCTTTCAA
CGCCACCCTCGCTCGACCA->GCCACCCTCGCTCGACCAC
TATTGGCCCATCTAAATCC->ATTGGCCCATCTAAATCCG
GCCAATTGGCGGTCGCGCC->CCAATTGGCGGTCGCGCCC
TCGCTTATCATTGCCTAAC->CGCTTATCATTGCCTAACC
CCAGTTGCTAGCCATCATC->CAGTTGCTAGCCATCATCA
TACATTGCACACTAAGTAG->ACATTGCACACTAAGTAGC
CCACCCAGCAAGTTCCCTA->CACCCAGCAAGTTCCCTAA
CGAAAGGTCGGTGGCTATT->GAAAGGTCGGTGGCTATTA
CCGCATGAAGCGCAGTTAC->CGCATGAAGCGCAGTTACG
CAGTTGCTAGCCATCATCA->AGTTGCTAGCCATCATCAA
CTAGTCCCCCAGTCAGTGT->TAGTCCCCCAGTCAGTGTT
GCTCGAATTATGTTAGTAC->CTCGAATTATGTTAGTACG
ACATCTGTTCGCCAATTGG->CATCTGTTCGCCAATTGGC
GGGGAGTTCTGGTGTCCCG->GGGAGTTCTGGTGTCCCGG
ACTATTTTTACTGAGGATA->CTATTTTTACTGAGGATAC
GGAATGACAACCTCTGACC->GAATGACAACCTCTGACCG
CCGTTACGGAAGGATCTGT->CGTTACGGAAGGATCTGTC
CCCATCTAAATCCGGAAAA->CCATCTAAATCCGGAAAAA
CTGCGAGCCTGCAGGAAGC->TGCGAGCCTGCAGGAAGCC
GTTATTGAGGAATCGTCCA->TTATTGAGGAATCGTCCAT
CCGTTTGGCATGGTGTATA->CGTTTGGCATGGTGTATAT
GCTAGTCCCCCAGTCAGTG->CTAGTCCCCCAGTCAGTGT
TGGCCCATCTAAATCCGGA->GGCCCATCTAAATCCGGAA
GGCTATTAAGTCTGTTCGC->GCTATTAAGTCTGTTCGCG
AAATCTAATTGAACTCAGT->AATCTAATTGAACTCAGTT
GCTACCAAGCTAGCCCTAT->CTACCAAGCTAGCCCTATC
TATTAAGTCTGTTCGCGCG->ATTAAGTCTGTTCGCGCGC
GCGCTAAAAGGCTCAAGAA->CGCTAAAAGGCTCAAGAAA
TCGATTCCCGCATCTGCTC->CGATTCCCGCATCTGCTCA
AGGATCTGTCACATCTCTG->GGATCTGTCACATCTCTGT
TATATATTATTACGACATA->ATATATTATTACGACATAA
TCTAAATCCGGAAAAACAA->CTAAATCCGGAAAAACAAG
ACCTCAACTTTAGGCCAAG->CCTCAACTTTAGGCCAAGA
TCCCCCAGTCAGTGTTCAT->CCCCCAGTCAGTGTTCATT
CTTTACATCCTTCCGTTAA->TTTACATCCTTCCGTTAAC
CATGGTTCCGGGCTACTAC->ATGGTTCCGGGCTACTACG
TGGTGTATATATTATTACG->GGTGTATATATTATTACGA
TACACCACCCAGCAAGTTC->ACACCACCCAGCAAGTTCC
AGCTATGTCACATATCTGT->GCTATGTCACATATCTGTC
AGTCCCCCAGTCAGTGTTC->GTCCCCCAGTCAGTGTTCA
GTCCGAGTCATATTCTGCG->TCCGAGTCATATTCTGCGG
ACTACTCTAAGTAATGAAA->CTACTCTAAGTAATGAAAG
TATTACGACATAAGTCCTG->ATTACGACATAAGTCCTGC
CACATATCTGTCGTTAGGC->ACATATCTGTCGTTAGGCT
CTCTTTGTGCAGCTTATAT->TCTTTGTGCAGCTTATATG
CCGGAAAAACAAGTTGTAC->CGGAAAAACAAGTTGTACA
ACTCTAAGTAATGAAAGCC->CTCTAAGTAATGAAAGCCG
GGGCAAGTCATCGTACATT->GGCAAGTCATCGTACATTG
AATAGTACATGGATTCATA->ATAGTACATGGATTCATAC
TCACGCAAACCCAAATAAT->CACGCAAACCCAAATAATT
CGAAGCTTTGATCTCGAGG->GAAGCTTTGATCTCGAGGG
TGACAACCTCTGACCGATT->GACAACCTCTGACCGATTC
CTATTAAGTCTGTTCGCGC->TATTAAGTCTGTTCGCGCG
AACCTTGACCGCCTCCTGC->ACCTTGACCGCCTCCTGCG
TCTTGTTAATTGATTCCGG->CTTGTTAATTGATTCCGGT
GTGTCTTACCTCAACTTTA->TGTCTTACCTCAACTTTAG
ATTAACACTGGTATAGTTA->TTAACACTGGTATAGTTAT
AAATCCCCTTCCCTATTTT->AATCCCCTTCCCTATTTTC
AGGTTTTAGTCCCTAACTA->GGTTTTAGTCCCTAACTAA
AACCTAACCTTGACCGCCT->ACCTAACCTTGACCGCCTC
AGGCTTCAGTATCTGCCGG->GGCTTCAGTATCTGCCGGA
AGATCAGTCGCAATCAGAA->GATCAGTCGCAATCAGAAT
CTTATCATTGCCTAACCAA->TTATCATTGCCTAACCAAG
TAGTTATTGAGGAATCGTC->AGTTATTGAGGAATCGTCC
GACCGCCTCCTGCGAGCCT->ACCGCCTCCTGCGAGCCTG
TTGAAGAAATCATATTCAC->TGAAGAAATCATATTCACG
ATCATCAAAAGGAGTGTAA->TCATCAAAAGGAGTGTAAA
ACATCCTTCCGTTAACGGT->CATCCTTCCGTTAACGGTC
ATCAGCTATGTCACATATC->TCAGCTATGTCACATATCT
ATGGATTCATACCGAAACA->TGGATTCATACCGAAACAT
CATTTCCTAGTCACTGCTT->ATTTCCTAGTCACTGCTTG
TAGTCCCCCAGTCAGTGTT->AGTCCCCCAGTCAGTGTTC
TACCTCCATATGCTCAAGA->ACCTCCATATGCTCAAGAA
GTTCGCGCGCTACCAAGCT->TTCGCGCGCTACCAAGCTA
ACAAGGTTTTAGTCCCTAA->CAAGGTTTTAGTCCCTAAC
AAGGGGCCAGCCTTATGCA->AGGGGCCAGCCTTATGCAA
GATTGATATTCCCGTTACG->ATTGATATTCCCGTTACGG
AAATATCCACTTAAGTTAA->AATATCCACTTAAGTTAAC
TAGTGAAGCTCATCGGAGG->AGTGAAGCTCATCGGAGGC
TAGTACGTAGACTTCGTAT->AGTACGTAGACTTCGTATT
TCTCCGCTCAGTGAACAAC->CTCCGCTCAGTGAACAACC
GTGGTGCAAGTACACCACC->TGGTGCAAGTACACCACCC
TAAACCACATCTGTTCGCC->AAACCACATCTGTTCGCCA
ACAGACCCCAGGCTATAAA->CAGACCCCAGGCTATAAAA
TGGAATAGCGTAACGCGTG->GGAATAGCGTAACGCGTGT
TTGCACATTTCCTAGTCAC->TGCACATTTCCTAGTCACT
GGGTCCTCTCTCGATTCCC->GGTCCTCTCTCGATTCCCG
GTTGCACTCGGTAGTCCCC->TTGCACTCGGTAGTCCCCT
CTTCACGCGACTGACATTA->TTCACGCGACTGACATTAA
TCCTAGATTCATGCGCTAG->CCTAGATTCATGCGCTAGC
AAGTCCGAGTTCGCTATAC->AGTCCGAGTTCGCTATACG
CTTGACCTCCGCCAACCAC->TTGACCTCCGCCAACCACA
TCGTACATTGCACACTAAG->CGTACATTGCACACTAAGT
AACCACATCTGTTCGCCAA->ACCACATCTGTTCGCCAAT
GCTGTATTCACCCTCATCG->CTGTATTCACCCTCATCGG
CCAGCGACAGTTTACTTGT->CAGCGACAGTTTACTTGTG
TCTTCACGCGACTGACATT->CTTCACGCGACTGACATTA
AACAACCAATACCGCCACC->ACAACCAATACCGCCACCC
ATCCTTCCGTTAACGGTCC->TCCTTCCGTTAACGGTCCG
CGGGTAGTAAATCTAATTG->GGGTAGTAAATCTAATTGA
GCTGACGCGGATCCACCGC->CTGACGCGGATCCACCGCG
AGGCGGGCCAATATAATGG->GGCGGGCCAATATAATGGG
AGTACATGGATTCATACCG->GTACATGGATTCATACCGA
GGCCAAGATTCCTTATCGA->GCCAAGATTCCTTATCGAA
CGCAAACCCAAATAATTAA->GCAAACCCAAATAATTAAC
GAGTACCAAAGATGGTCGG->AGTACCAAAGATGGTCGGT
GGCGGTCGCGCCCAGGGTC->GCGGTCGCGCCCAGGGTCC
CCTCAACTTTAGGCCAAGA->CTCAACTTTAGGCCAAGAT
AAAGTATCTGATTAGAGTC->AAGTATCTGATTAGAGTCG
AGTCAGTGTTCATTTCTTG->GTCAGTGTTCATTTCTTGT
CGCCTCTGACCACTAGCGC->GCCTCTGACCACTAGCGCA
CTCAATAACCTAACCTTGA->TCAATAACCTAACCTTGAC
GAGTTCTGGTGTCCCGGCA->AGTTCTGGTGTCCCGGCAA
GCCTATACGGGACTCCCAG->CCTATACGGGACTCCCAGA
ATCGGTCATCGATAAATGC->TCGGTCATCGATAAATGCT
AGCGTAACGCGTGTTTCGC->GCGTAACGCGTGTTTCGCT
AAGTTAACTCTATAATCTC->AGTTAACTCTATAATCTCC
ACTTCGTATTTGCCGGGTA->CTTCGTATTTGCCGGGTAG
ACGCCTCAATAACCTAACC->CGCCTCAATAACCTAACCT
CATACCGAAACATGGTTCC->ATACCGAAACATGGTTCCG
ACAAGAAATCCCCTTCCCT->CAAGAAATCCCCTTCCCTA
TTTCTTGTTAATTGATTCC->TTCTTGTTAATTGATTCCG
CCGGGCTACTACGGGAAAG->CGGGCTACTACGGGAAAGT
ATTGCTCTTTGTGCAGCTT->TTGCTCTTTGTGCAGCTTA
ACGCCAGCTGACGCGGATC->CGCCAGCTGACGCGGATCC
GGGGCCAGTAGTATACTGC->GGGCCAGTAGTATACTGCA
GTCAGCGGTTCCCGACCGT->TCAGCGGTTCCCGACCGTC
CCCAAATAATTAACACTGG->CCAAATAATTAACACTGGT
CAACCTCGCCAGCGTTTAA->AACCTCGCCAGCGTTTAAA
CTCAAGAAAGGGGCCAGTA->TCAAGAAAGGGGCCAGTAG
ATGTGTCTTACCTCAACTT->TGTGTCTTACCTCAACTTT
GTCGCGAAAGGTCGGTGGC->TCGCGAAAGGTCGGTGGCT
CAGTAAGCGGACCTAACCT->AGTAAGCGGACCTAACCTT
TAAGTCTGTTCGCGCGCTA->AAGTCTGTTCGCGCGCTAC
CCACATATGTTGCACTCGG->CACATATGTTGCACTCGGT
CCAAGATTCCTTATCGAAG->CAAGATTCCTTATCGAAGC
GAGGATACGCAACTCCCGT->AGGATACGCAACTCCCGTA
GCCAAGATTCCTTATCGAA->CCAAGATTCCTTATCGAAG
ATATGCTCAAGAAAGGGGC->TATGCTCAAGAAAGGGGCC
CGCATTATGCTCACCTCTT->GCATTATGCTCACCTCTTC
AGGTCAATCTTTCCGCATT->GGTCAATCTTTCCGCATTA
CCTAACCAAGTTGTGGCGA->CTAACCAAGTTGTGGCGAC
GCCTCAATAACCTAACCTT->CCTCAATAACCTAACCTTG
TGCACCTAACCTTGACCGC->GCACCTAACCTTGACCGCC
TTGGCATGGTGTATATATT->TGGCATGGTGTATATATTA
GGTAGTCCCCTCGTTTAAA->GTAGTCCCCTCGTTTAAAC
CTCAGTGAACAACCAATAC->TCAGTGAACAACCAATACC
CTCAGATTGATATTCCCGT->TCAGATTGATATTCCCGTT
CAGTCGTGTCATGGAATAG->AGTCGTGTCATGGAATAGC
TCATCGGGTAGGAGCCCTC->CATCGGGTAGGAGCCCTCA
AAAAGGCTTCTCGATAATC->AAAGGCTTCTCGATAATCT
ATTGAGGAATCGTCCATCC->TTGAGGAATCGTCCATCCG
GCGGTCGCGCCCAGGGTCC->CGGTCGCGCCCAGGGTCCT
TCGATAAATGCTGTCATAT->CGATAAATGCTGTCATATC
CTAACCAAGTTGTGGCGAC->TAACCAAGTTGTGGCGACG
CAACTTTAGGCCAAGATTC->AACTTTAGGCCAAGATTCC
AAGGGACAACTACATTGTA->AGGGACAACTACATTGTAT
AAGCCGAGTGTGGTGCAAG->AGCCGAGTGTGGTGCAAGT
GGTATAGTTATTGAGGAAT->GTATAGTTATTGAGGAATC
CTCATCGGGTAGGAGCCCT->TCATCGGGTAGGAGCCCTC
TGGTTTCTGGCCTATACGG->GGTTTCTGGCCTATACGGG
ATCGATAAATGCTGTCATA->TCGATAAATGCTGTCATAT
CCTTGACCGCCTCCCGTTT->CTTGACCGCCTCCCGTTTG
TTTACTGAGGATACGCAAC->TTACTGAGGATACGCAACT
TATCCACTTAAGTTAACTC->ATCCACTTAAGTTAACTCT
ACACTAAGTAGCCTATTCC->CACTAAGTAGCCTATTCCA
ATGGTCGGTAGGCGGGCCA->TGGTCGGTAGGCGGGCCAA
ATCCGTGTGGTCGAATAGA->TCCGTGTGGTCGAATAGAC
GCTGGTTTCTGGCCTATAC->CTGGTTTCTGGCCTATACG
TTTCAGACTACTCTAAGTA->TTCAGACTACTCTAAGTAA
TTGTGCTTTACATCCTTCC->TGTGCTTTACATCCTTCCG
CCAATTGGCGGTCGCGCCC->CAATTGGCGGTCGCGCCCA
AGTTGCTAGCCATCATCAA->GTTGCTAGCCATCATCAAA
CCCTATTTTCCACCCCATC->CCTATTTTCCACCCCATCC
ACGCCACTCTCCCACTATT->CGCCACTCTCCCACTATTT
GTACGATACAATAATCTGG->TACGATACAATAATCTGGA
TCCTGCCGCATGAAGCGCA->CCTGCCGCATGAAGCGCAG
CGTGTCATGGAATAGCGTA->GTGTCATGGAATAGCGTAA
ATGGGCCAATAGGTTGAGT->TGGGCCAATAGGTTGAGTG
AATCTACGCCTGAAGGTAA->ATCTACGCCTGAAGGTAAG
CTGACCACTAGCGCACAAG->TGACCACTAGCGCACAAGA
CCCACTATTTTTACTGAGG->CCACTATTTTTACTGAGGA
CCAACCACATATGTTGCAC->CAACCACATATGTTGCACT
AGAAAGGGGCCAGTAGTAT->GAAAGGGGCCAGTAGTATA
CCCGTTTGGCATGGTGTAT->CCGTTTGGCATGGTGTATA
GAAAGACTCAGATTGATAT->AAAGACTCAGATTGATATT
ACAACGCCAGCTGACGCGG->CAACGCCAGCTGACGCGGA
ATATGTGTCTTACCTCAAC->TATGTGTCTTACCTCAACT
AGCCTGCAGGAAGCCAGGT->GCCTGCAGGAAGCCAGGTG
TCCAGGTCAATCTTTCCGC->CCAGGTCAATCTTTCCGCA
TCAGCTATGTCACATATCT->CAGCTATGTCACATATCTG
AATCATATTCACGCAAACC->ATCATATTCACGCAAACCC
GCGGACGCATCCGAGCACA->CGGACGCATCCGAGCACAG
GCCTATTCCAGGTCAATCT->CCTATTCCAGGTCAATCTT
GAAAGCCCTCTGCCGTTTT->AAAGCCCTCTGCCGTTTTA
CAGCCTTATGCAAGACCTA->AGCCTTATGCAAGACCTAA
TATTTTTACTGAGGATACG->ATTTTTACTGAGGATACGC
TCGGAGGCCAGTTGCTAGC->CGGAGGCCAGTTGCTAGCC
AGCCCTCTGCCGTTTTATT->GCCCTCTGCCGTTTTATTG
CACTATTTTTACTGAGGAT->ACTATTTTTACTGAGGATA
GCGGGCCAATATAATGGGC->CGGGCCAATATAATGGGCC
AGAATTGTCTGGGTCCCGT->GAATTGTCTGGGTCCCGTA
TGGCATGGTGTATATATTA->GGCATGGTGTATATATTAT
TGTATTGGCCCATCTAAAT->GTATTGGCCCATCTAAATC
CGTCAGCTGTATTCACCCT->GTCAGCTGTATTCACCCTC
GAAGGTAAGTCCGAGTTCG->AAGGTAAGTCCGAGTTCGC
TCTGTTCGCCAATTGGCGG->CTGTTCGCCAATTGGCGGT
GAAACATGGTTCCGGGCTA->AAACATGGTTCCGGGCTAC
AGCACAGAGTCGTCCGGGG->GCACAGAGTCGTCCGGGGG
ACCCCGGAAAGACTCAGAT->CCCCGGAAAGACTCAGATT
GAGGTCATCCCACATCAAT->AGGTCATCCCACATCAATA
CAGCGTTTAAAAAGGCTTC->AGCGTTTAAAAAGGCTTCT
ATCGGGTAGGAGCCCTCAG->TCGGGTAGGAGCCCTCAGA
AAAACAAGTTGTACATATA->AAACAAGTTGTACATATAC
GGCGACGTACGATACAATA->GCGACGTACGATACAATAA
AAAGGCTCAAGAAAGGGGC->AAGGCTCAAGAAAGGGGCC
CAATATAATGGGCCAATAG->AATATAATGGGCCAATAGG
GTTAGGCTTCAGTATCTGC->TTAGGCTTCAGTATCTGCC
TAACGGTCCGAGTCATATT->AACGGTCCGAGTCATATTC
AGTTATTGAGGAATCGTCC->GTTATTGAGGAATCGTCCA
AACCTTGACCGCCTCGCTT->ACCTTGACCGCCTCGCTTG
AGGAGTGTAAAAATGTGCC->GGAGTGTAAAAATGTGCCT
TCGAAGCTTTGATCTCGAG->CGAAGCTTTGATCTCGAGG
GTGTCATGGAATAGCGTAA->TGTCATGGAATAGCGTAAC
TCATCAAAAGGAGTGTAAA->CATCAAAAGGAGTGTAAAA
GTAGTAAATCTAATTGAAC->TAGTAAATCTAATTGAACT
TCTGTGCTGGTTTCTGGCC->CTGTGCTGGTTTCTGGCCT
AGGGTCCTCTCTCGATTCC->GGGTCCTCTCTCGATTCCC
GAGCCTGCAGGAAGCCAGG->AGCCTGCAGGAAGCCAGGT
TGTTCGCGCGCTACCAAGC->GTTCGCGCGCTACCAAGCT
ATGGTTCCGGGCTACTACG->TGGTTCCGGGCTACTACGG
ATTCCCGTTACGGAAGGAT->TTCCCGTTACGGAAGGATC
AGTTGTGGCGACGTACGAT->GTTGTGGCGACGTACGATA
TTGACCTCCGCCAACCACA->TGACCTCCGCCAACCACAT
